geoid,name,B23025001,"B23025001, Error",,"B23025002, Error",Civilian Labor Force,"B23025003, Error",Employed,"B23025004, Error",Unemployed,"B23025005, Error",B23025006,"B23025006, Error",B23025007,"B23025007, Error"
14000US17031010100,"Census Tract 101, Cook, IL",3547,345,2616,308,2616,308,2405,283,211,122,0,11,931,282
14000US17031010201,"Census Tract 102.01, Cook, IL",5617,637,3404,405,3404,405,3129,400,275,129,0,15,2213,437
14000US17031010202,"Census Tract 102.02, Cook, IL",2095,233,1318,189,1318,189,1224,185,94,53,0,11,777,149
14000US17031010300,"Census Tract 103, Cook, IL",5655,434,3384,335,3384,335,3149,301,235,156,0,15,2271,376
14000US17031010400,"Census Tract 104, Cook, IL",4783,423,2916,380,2916,380,2663,376,253,121,0,15,1867,301
14000US17031010501,"Census Tract 105.01, Cook, IL",3643,353,2749,351,2749,351,2464,355,285,168,0,11,894,172
14000US17031010502,"Census Tract 105.02, Cook, IL",2426,230,1878,189,1878,189,1798,177,80,45,0,11,548,151
14000US17031010503,"Census Tract 105.03, Cook, IL",1905,303,1059,233,1038,226,976,209,62,52,21,34,846,174
14000US17031010600,"Census Tract 106, Cook, IL",5607,624,4534,561,4524,560,4019,474,505,253,10,16,1073,254
14000US17031010701,"Census Tract 107.01, Cook, IL",2986,271,2221,233,2221,233,2115,220,106,64,0,11,765,147
14000US17031010702,"Census Tract 107.02, Cook, IL",4027,390,3111,354,3111,354,2939,330,172,81,0,15,916,210
14000US17031020100,"Census Tract 201, Cook, IL",3354,396,1971,293,1971,293,1718,275,253,140,0,11,1383,416
14000US17031020200,"Census Tract 202, Cook, IL",4997,420,3225,354,3225,354,2979,383,246,147,0,15,1772,436
14000US17031020301,"Census Tract 203.01, Cook, IL",3861,290,2142,212,2142,212,1985,201,157,88,0,15,1719,205
14000US17031020302,"Census Tract 203.02, Cook, IL",3865,326,2612,273,2612,273,2284,260,328,141,0,15,1253,215
14000US17031020400,"Census Tract 204, Cook, IL",3553,286,2430,234,2430,234,2262,229,168,74,0,11,1123,198
14000US17031020500,"Census Tract 205, Cook, IL",5169,663,3204,489,3204,489,2790,471,414,234,0,15,1965,340
14000US17031020601,"Census Tract 206.01, Cook, IL",4654,385,2794,414,2794,414,2517,408,277,164,0,15,1860,449
14000US17031020602,"Census Tract 206.02, Cook, IL",3422,388,2203,298,2203,298,1989,280,214,90,0,11,1219,208
14000US17031020701,"Census Tract 207.01, Cook, IL",1341,160,892,148,892,148,834,141,58,29,0,11,449,101
14000US17031020702,"Census Tract 207.02, Cook, IL",5961,483,4140,525,4140,525,3803,536,337,170,0,15,1821,371
14000US17031020801,"Census Tract 208.01, Cook, IL",4309,406,3111,384,3111,384,2887,377,224,115,0,15,1198,254
14000US17031020802,"Census Tract 208.02, Cook, IL",6376,674,4222,557,4222,557,3939,505,283,174,0,15,2154,418
14000US17031020901,"Census Tract 209.01, Cook, IL",4399,433,3082,345,3082,345,2897,348,185,109,0,15,1317,233
14000US17031020902,"Census Tract 209.02, Cook, IL",3678,388,2093,353,2093,353,1974,354,119,67,0,11,1585,253
14000US17031030101,"Census Tract 301.01, Cook, IL",3252,319,2263,291,2263,291,2085,285,178,93,0,11,989,203
14000US17031030102,"Census Tract 301.02, Cook, IL",2676,238,1901,225,1901,225,1780,208,121,58,0,11,775,153
14000US17031030103,"Census Tract 301.03, Cook, IL",2136,290,1373,241,1373,241,1249,209,124,72,0,11,763,183
14000US17031030104,"Census Tract 301.04, Cook, IL",3306,417,1781,283,1781,283,1540,252,241,113,0,11,1525,287
14000US17031030200,"Census Tract 302, Cook, IL",4595,513,3379,457,3379,457,3165,437,214,137,0,15,1216,306
14000US17031030300,"Census Tract 303, Cook, IL",2768,264,1917,234,1917,234,1771,225,146,64,0,11,851,184
14000US17031030400,"Census Tract 304, Cook, IL",2351,180,1826,194,1826,194,1572,175,254,104,0,11,525,115
14000US17031030500,"Census Tract 305, Cook, IL",5757,471,4624,389,4624,389,4528,402,96,76,0,15,1133,251
14000US17031030601,"Census Tract 306.01, Cook, IL",3478,371,2217,306,2217,306,2164,309,53,71,0,11,1261,248
14000US17031030603,"Census Tract 306.03, Cook, IL",1787,175,1319,149,1319,149,1277,153,42,26,0,11,468,143
14000US17031030604,"Census Tract 306.04, Cook, IL",2908,261,1832,201,1832,201,1739,191,93,74,0,11,1076,164
14000US17031030701,"Census Tract 307.01, Cook, IL",1459,139,1015,99,1015,99,935,107,80,36,0,11,444,122
14000US17031030702,"Census Tract 307.02, Cook, IL",945,102,640,97,640,97,567,78,73,42,0,11,305,110
14000US17031030703,"Census Tract 307.03, Cook, IL",2538,250,1653,239,1653,239,1564,222,89,73,0,11,885,220
14000US17031030706,"Census Tract 307.06, Cook, IL",3836,325,2303,301,2303,301,2110,269,193,116,0,11,1533,245
14000US17031030800,"Census Tract 308, Cook, IL",3846,388,2452,327,2452,327,2388,322,64,54,0,11,1394,266
14000US17031030900,"Census Tract 309, Cook, IL",2839,368,2120,393,2120,393,2040,392,80,62,0,11,719,141
14000US17031031000,"Census Tract 310, Cook, IL",3573,310,2950,288,2943,292,2798,270,145,74,7,12,623,143
14000US17031031100,"Census Tract 311, Cook, IL",4341,386,3518,357,3518,357,3333,334,185,126,0,11,823,212
14000US17031031200,"Census Tract 312, Cook, IL",4788,486,2931,451,2931,451,2803,436,128,100,0,15,1857,306
14000US17031031300,"Census Tract 313, Cook, IL",7182,544,4456,532,4456,532,4203,468,253,180,0,15,2726,480
14000US17031031400,"Census Tract 314, Cook, IL",4706,338,3414,302,3414,302,3315,314,99,69,0,11,1292,303
14000US17031031501,"Census Tract 315.01, Cook, IL",3389,302,1985,253,1977,255,1730,235,247,166,8,12,1404,245
14000US17031031502,"Census Tract 315.02, Cook, IL",3854,437,2809,421,2782,424,2474,429,308,162,27,42,1045,190
14000US17031031700,"Census Tract 317, Cook, IL",6108,530,4620,403,4620,403,4175,416,445,198,0,15,1488,320
14000US17031031800,"Census Tract 318, Cook, IL",1534,103,1327,112,1327,112,1286,113,41,25,0,11,207,50
14000US17031031900,"Census Tract 319, Cook, IL",2308,201,1774,179,1774,179,1651,153,123,70,0,11,534,128
14000US17031032100,"Census Tract 321, Cook, IL",6680,856,4627,636,4627,636,4346,663,281,168,0,15,2053,610
14000US17031040100,"Census Tract 401, Cook, IL",3230,291,2260,183,2260,183,2203,168,57,47,0,11,970,186
14000US17031040201,"Census Tract 402.01, Cook, IL",6061,444,4638,457,4638,457,4447,441,191,94,0,15,1423,295
14000US17031040202,"Census Tract 402.02, Cook, IL",6034,528,3779,470,3779,470,3666,461,113,74,0,15,2255,360
14000US17031040300,"Census Tract 403, Cook, IL",2598,248,1736,242,1736,242,1565,197,171,111,0,11,862,168
14000US17031040401,"Census Tract 404.01, Cook, IL",2739,294,2141,284,2141,284,2030,250,111,65,0,11,598,151
14000US17031040402,"Census Tract 404.02, Cook, IL",4105,269,3701,279,3701,279,3611,275,90,81,0,15,404,111
14000US17031040600,"Census Tract 406, Cook, IL",2220,324,1882,290,1882,290,1751,236,131,130,0,11,338,86
14000US17031040700,"Census Tract 407, Cook, IL",2827,306,2178,204,2178,204,2084,195,94,52,0,11,649,177
14000US17031040800,"Census Tract 408, Cook, IL",1527,111,1112,94,1112,94,1089,94,23,17,0,11,415,91
14000US17031040900,"Census Tract 409, Cook, IL",1705,204,1408,184,1408,184,1391,184,17,17,0,11,297,78
14000US17031050100,"Census Tract 501, Cook, IL",2225,227,1777,169,1777,169,1690,170,87,44,0,11,448,129
14000US17031050200,"Census Tract 502, Cook, IL",3960,322,2915,333,2915,333,2812,319,103,58,0,15,1045,223
14000US17031050300,"Census Tract 503, Cook, IL",2053,161,1578,160,1578,160,1447,160,131,57,0,11,475,138
14000US17031050500,"Census Tract 505, Cook, IL",4629,331,3757,333,3757,333,3664,338,93,67,0,15,872,262
14000US17031050600,"Census Tract 506, Cook, IL",1966,167,1713,176,1713,176,1653,181,60,48,0,11,253,87
14000US17031050700,"Census Tract 507, Cook, IL",1286,117,1126,115,1126,115,1112,117,14,13,0,11,160,41
14000US17031050800,"Census Tract 508, Cook, IL",1119,81,953,89,953,89,900,97,53,30,0,11,166,57
14000US17031050900,"Census Tract 509, Cook, IL",1112,140,911,116,911,116,879,113,32,16,0,11,201,58
14000US17031051000,"Census Tract 510, Cook, IL",1347,113,1066,121,1066,121,1054,123,12,12,0,11,281,53
14000US17031051100,"Census Tract 511, Cook, IL",1244,173,1031,137,1031,137,1025,137,6,11,0,11,213,94
14000US17031051200,"Census Tract 512, Cook, IL",1248,121,1035,125,1035,125,1004,121,31,35,0,11,213,61
14000US17031051300,"Census Tract 513, Cook, IL",2101,155,1830,173,1830,173,1767,151,63,55,0,11,271,83
14000US17031051400,"Census Tract 514, Cook, IL",1456,176,1141,124,1141,124,1092,125,49,28,0,11,315,115
14000US17031060100,"Census Tract 601, Cook, IL",2212,210,1835,172,1835,172,1810,173,25,25,0,11,377,112
14000US17031060200,"Census Tract 602, Cook, IL",1932,192,1676,180,1676,180,1607,184,69,49,0,11,256,94
14000US17031060300,"Census Tract 603, Cook, IL",2705,260,2376,275,2376,275,2303,268,73,52,0,11,329,86
14000US17031060400,"Census Tract 604, Cook, IL",3194,293,2820,291,2820,291,2743,300,77,88,0,11,374,118
14000US17031060500,"Census Tract 605, Cook, IL",1133,85,787,95,787,95,766,95,21,27,0,11,346,70
14000US17031060800,"Census Tract 608, Cook, IL",4454,388,3719,315,3713,318,3545,316,168,82,6,13,735,175
14000US17031060900,"Census Tract 609, Cook, IL",6900,759,5824,790,5792,796,5490,682,302,223,32,35,1076,310
14000US17031061000,"Census Tract 610, Cook, IL",1967,165,1782,170,1782,170,1746,166,36,21,0,11,185,60
14000US17031061100,"Census Tract 611, Cook, IL",1308,151,1146,134,1146,134,1135,135,11,11,0,11,162,60
14000US17031061200,"Census Tract 612, Cook, IL",1632,203,1433,182,1433,182,1397,184,36,27,0,11,199,66
14000US17031061500,"Census Tract 615, Cook, IL",1709,146,1517,141,1517,141,1472,144,45,27,0,11,192,57
14000US17031061800,"Census Tract 618, Cook, IL",1125,91,966,107,966,107,922,105,44,30,0,11,159,59
14000US17031061901,"Census Tract 619.01, Cook, IL",3267,324,2687,310,2687,310,2563,324,124,73,0,11,580,135
14000US17031061902,"Census Tract 619.02, Cook, IL",4331,331,3063,337,3063,337,2882,337,181,86,0,11,1268,273
14000US17031062000,"Census Tract 620, Cook, IL",2826,290,2462,287,2462,287,2406,281,56,33,0,11,364,126
14000US17031062100,"Census Tract 621, Cook, IL",3485,309,2863,326,2863,326,2767,329,96,48,0,11,622,173
14000US17031062200,"Census Tract 622, Cook, IL",2536,292,2309,285,2292,282,2195,284,97,62,17,26,227,94
14000US17031062300,"Census Tract 623, Cook, IL",1406,120,1218,127,1218,127,1177,127,41,35,0,11,188,55
14000US17031062400,"Census Tract 624, Cook, IL",1201,155,988,175,988,175,959,169,29,26,0,11,213,58
14000US17031062500,"Census Tract 625, Cook, IL",1333,119,1216,109,1216,109,1192,105,24,23,0,11,117,44
14000US17031062600,"Census Tract 626, Cook, IL",1727,148,1469,131,1469,131,1398,127,71,41,0,11,258,72
14000US17031062700,"Census Tract 627, Cook, IL",2283,347,1886,297,1886,297,1861,298,25,24,0,11,397,119
14000US17031062800,"Census Tract 628, Cook, IL",3097,205,2786,215,2786,215,2734,217,52,34,0,11,311,103
14000US17031062900,"Census Tract 629, Cook, IL",3523,288,3072,258,3072,258,3008,257,64,33,0,11,451,130
14000US17031063000,"Census Tract 630, Cook, IL",2862,212,2604,205,2604,205,2511,202,93,71,0,11,258,101
14000US17031063100,"Census Tract 631, Cook, IL",2073,137,1865,147,1865,147,1812,144,53,33,0,11,208,82
14000US17031063200,"Census Tract 632, Cook, IL",6529,460,4969,400,4969,400,4842,405,127,98,0,15,1560,430
14000US17031063301,"Census Tract 633.01, Cook, IL",2486,193,1755,222,1755,222,1747,222,8,12,0,11,731,132
14000US17031063302,"Census Tract 633.02, Cook, IL",3944,297,3183,284,3183,284,3165,285,18,22,0,11,761,231
14000US17031063303,"Census Tract 633.03, Cook, IL",1269,96,652,84,652,84,627,85,25,20,0,11,617,73
14000US17031063400,"Census Tract 634, Cook, IL",2034,180,1878,173,1878,173,1851,175,27,34,0,11,156,69
14000US17031070101,"Census Tract 701.01, Cook, IL",3336,266,2438,269,2438,269,2327,267,111,71,0,11,898,218
14000US17031070102,"Census Tract 701.02, Cook, IL",2735,252,2300,229,2300,229,2234,217,66,43,0,11,435,152
14000US17031070103,"Census Tract 701.03, Cook, IL",1503,152,1325,157,1325,157,1267,157,58,42,0,11,178,56
14000US17031070200,"Census Tract 702, Cook, IL",3585,361,3054,370,3054,370,2993,369,61,46,0,11,531,132
14000US17031070300,"Census Tract 703, Cook, IL",3177,278,2759,264,2759,264,2667,254,92,63,0,11,418,113
14000US17031070400,"Census Tract 704, Cook, IL",2948,196,2099,194,2099,194,2099,194,0,11,0,11,849,143
14000US17031070500,"Census Tract 705, Cook, IL",2720,257,2001,239,2001,239,1920,222,81,74,0,11,719,183
14000US17031070600,"Census Tract 706, Cook, IL",2622,222,2169,260,2169,260,2125,259,44,33,0,11,453,158
14000US17031070700,"Census Tract 707, Cook, IL",3419,274,2840,257,2840,257,2772,258,68,40,0,11,579,156
14000US17031071000,"Census Tract 710, Cook, IL",4091,451,2480,271,2480,271,2320,273,160,73,0,11,1611,345
14000US17031071100,"Census Tract 711, Cook, IL",2802,331,2210,265,2210,265,2126,265,84,44,0,11,592,124
14000US17031071200,"Census Tract 712, Cook, IL",1631,164,1313,162,1313,162,1295,160,18,16,0,11,318,95
14000US17031071300,"Census Tract 713, Cook, IL",3097,320,2419,293,2419,293,2351,298,68,50,0,11,678,185
14000US17031071400,"Census Tract 714, Cook, IL",4449,394,3198,370,3198,370,3138,373,60,51,0,11,1251,258
14000US17031071500,"Census Tract 715, Cook, IL",5436,313,4624,318,4624,318,4534,310,90,62,0,15,812,195
14000US17031071600,"Census Tract 716, Cook, IL",1308,120,900,103,900,103,829,111,71,52,0,11,408,89
14000US17031071700,"Census Tract 717, Cook, IL",1518,115,1215,122,1215,122,1177,124,38,28,0,11,303,71
14000US17031071800,"Census Tract 718, Cook, IL",2219,209,1617,203,1617,203,1566,184,51,51,0,11,602,160
14000US17031080100,"Census Tract 801, Cook, IL",6324,603,4629,607,4629,607,4419,629,210,135,0,15,1695,409
14000US17031080201,"Census Tract 802.01, Cook, IL",3198,265,2514,278,2514,278,2350,268,164,101,0,11,684,175
14000US17031080202,"Census Tract 802.02, Cook, IL",3152,284,2501,274,2501,274,2372,254,129,76,0,11,651,144
14000US17031080300,"Census Tract 803, Cook, IL",4047,339,3655,330,3655,330,3586,327,69,59,0,11,392,162
14000US17031080400,"Census Tract 804, Cook, IL",3168,467,2288,373,2288,373,2043,394,245,164,0,11,880,269
14000US17031081000,"Census Tract 810, Cook, IL",7477,553,4864,521,4864,521,4675,532,189,119,0,15,2613,336
14000US17031081100,"Census Tract 811, Cook, IL",3870,310,2995,310,2995,310,2841,297,154,118,0,11,875,180
14000US17031081201,"Census Tract 812.01, Cook, IL",4432,333,2865,348,2865,348,2739,348,126,66,0,11,1567,243
14000US17031081202,"Census Tract 812.02, Cook, IL",2807,243,1716,226,1716,226,1651,216,65,42,0,11,1091,149
14000US17031081300,"Census Tract 813, Cook, IL",5057,350,2883,390,2883,390,2756,395,127,81,0,15,2174,318
14000US17031081401,"Census Tract 814.01, Cook, IL",2263,218,1393,207,1393,207,1330,208,63,38,0,11,870,155
14000US17031081402,"Census Tract 814.02, Cook, IL",4620,461,3028,347,3028,347,2945,356,83,74,0,15,1592,289
14000US17031081403,"Census Tract 814.03, Cook, IL",7189,649,5588,578,5588,578,5407,589,181,138,0,15,1601,355
14000US17031081500,"Census Tract 815, Cook, IL",4702,366,3333,308,3333,308,3249,299,84,59,0,11,1369,325
14000US17031081600,"Census Tract 816, Cook, IL",3629,313,2854,323,2854,323,2742,343,112,71,0,11,775,156
14000US17031081700,"Census Tract 817, Cook, IL",3365,293,2937,271,2937,271,2812,268,125,68,0,11,428,157
14000US17031081800,"Census Tract 818, Cook, IL",8184,518,7480,473,7480,473,7325,479,155,102,0,15,704,245
14000US17031081900,"Census Tract 819, Cook, IL",776,102,577,76,577,76,566,75,11,9,0,11,199,81
14000US17031090100,"Census Tract 901, Cook, IL",2764,145,1895,167,1895,167,1847,165,48,37,0,11,869,118
14000US17031090200,"Census Tract 902, Cook, IL",5491,343,4037,346,4037,346,3897,332,140,85,0,15,1454,262
14000US17031090300,"Census Tract 903, Cook, IL",1089,94,775,97,775,97,770,98,5,7,0,11,314,50
14000US17031100100,"Census Tract 1001, Cook, IL",4439,382,2915,335,2915,335,2618,321,297,129,0,15,1524,284
14000US17031100200,"Census Tract 1002, Cook, IL",5650,362,3884,406,3884,406,3758,408,126,85,0,15,1766,260
14000US17031100300,"Census Tract 1003, Cook, IL",5427,410,2915,333,2915,333,2856,329,59,39,0,15,2512,317
14000US17031100400,"Census Tract 1004, Cook, IL",2513,137,1704,149,1704,149,1607,141,97,56,0,11,809,123
14000US17031100500,"Census Tract 1005, Cook, IL",4466,462,2765,386,2765,386,2746,384,19,27,0,15,1701,287
14000US17031100600,"Census Tract 1006, Cook, IL",3964,272,2689,257,2689,257,2521,244,168,77,0,11,1275,176
14000US17031100700,"Census Tract 1007, Cook, IL",3966,303,2696,274,2696,274,2552,264,144,70,0,11,1270,201
14000US17031110100,"Census Tract 1101, Cook, IL",4063,300,2723,300,2723,300,2487,329,236,146,0,15,1340,240
14000US17031110200,"Census Tract 1102, Cook, IL",2713,255,1750,183,1750,183,1591,177,159,86,0,11,963,194
14000US17031110300,"Census Tract 1103, Cook, IL",4360,365,2923,356,2923,356,2857,349,66,62,0,15,1437,191
14000US17031110400,"Census Tract 1104, Cook, IL",3890,256,2575,237,2575,237,2420,218,155,120,0,11,1315,205
14000US17031110501,"Census Tract 1105.01, Cook, IL",4361,330,2992,273,2992,273,2851,237,141,104,0,15,1369,233
14000US17031110502,"Census Tract 1105.02, Cook, IL",2813,284,1999,237,1999,237,1897,231,102,71,0,11,814,144
14000US17031120100,"Census Tract 1201, Cook, IL",2960,230,1859,235,1859,235,1850,234,9,12,0,11,1101,195
14000US17031120200,"Census Tract 1202, Cook, IL",3654,212,2409,162,2409,162,2288,167,121,68,0,11,1245,208
14000US17031120300,"Census Tract 1203, Cook, IL",5166,328,3479,300,3479,300,3347,294,132,71,0,15,1687,279
14000US17031120400,"Census Tract 1204, Cook, IL",2856,185,1909,189,1909,189,1803,187,106,49,0,11,947,161
14000US17031130100,"Census Tract 1301, Cook, IL",4186,505,1867,279,1867,279,1827,286,40,31,0,15,2319,324
14000US17031130200,"Census Tract 1302, Cook, IL",1271,101,905,119,905,119,843,104,62,35,0,11,366,68
14000US17031130300,"Census Tract 1303, Cook, IL",4491,289,2859,263,2859,263,2521,240,338,120,0,15,1632,223
14000US17031140100,"Census Tract 1401, Cook, IL",2616,419,1878,350,1878,350,1703,297,175,120,0,11,738,175
14000US17031140200,"Census Tract 1402, Cook, IL",5288,1033,3533,560,3533,560,3410,557,123,73,0,15,1755,629
14000US17031140301,"Census Tract 1403.01, Cook, IL",2165,317,1380,262,1380,262,1308,263,72,38,0,11,785,149
14000US17031140302,"Census Tract 1403.02, Cook, IL",3314,260,2240,195,2231,195,2034,197,197,76,9,13,1074,202
14000US17031140400,"Census Tract 1404, Cook, IL",5514,507,3743,421,3743,421,3510,428,233,137,0,15,1771,315
14000US17031140500,"Census Tract 1405, Cook, IL",3208,301,1952,245,1947,245,1774,228,173,82,5,8,1256,248
14000US17031140601,"Census Tract 1406.01, Cook, IL",2298,201,1454,177,1454,177,1322,175,132,58,0,11,844,131
14000US17031140602,"Census Tract 1406.02, Cook, IL",4194,543,3298,545,3268,549,2981,501,287,137,30,52,896,216
14000US17031140701,"Census Tract 1407.01, Cook, IL",2220,199,1711,181,1711,181,1600,185,111,55,0,11,509,116
14000US17031140702,"Census Tract 1407.02, Cook, IL",4842,408,3614,369,3592,369,3292,318,300,156,22,34,1228,213
14000US17031140800,"Census Tract 1408, Cook, IL",5683,576,4421,521,4421,521,4164,532,257,189,0,15,1262,219
14000US17031150200,"Census Tract 1502, Cook, IL",6452,522,4820,433,4820,433,4434,421,386,159,0,15,1632,314
14000US17031150300,"Census Tract 1503, Cook, IL",6840,499,4370,505,4370,505,4210,477,160,106,0,15,2470,446
14000US17031150401,"Census Tract 1504.01, Cook, IL",4016,351,2726,281,2726,281,2556,249,170,93,0,15,1290,245
14000US17031150402,"Census Tract 1504.02, Cook, IL",3162,335,2319,322,2319,322,2142,313,177,105,0,11,843,142
14000US17031150501,"Census Tract 1505.01, Cook, IL",3320,299,2339,300,2339,300,2107,270,232,100,0,11,981,156
14000US17031150502,"Census Tract 1505.02, Cook, IL",3269,381,2047,309,2047,309,1862,320,185,72,0,11,1222,216
14000US17031150600,"Census Tract 1506, Cook, IL",3188,344,2183,266,2183,266,2072,271,111,71,0,11,1005,196
14000US17031150700,"Census Tract 1507, Cook, IL",3355,266,2312,316,2284,319,2167,312,117,88,28,36,1043,176
14000US17031150800,"Census Tract 1508, Cook, IL",4122,365,3113,400,3113,400,2868,381,245,104,0,11,1009,199
14000US17031151001,"Census Tract 1510.01, Cook, IL",2013,239,1328,208,1328,208,1250,195,78,48,0,11,685,134
14000US17031151002,"Census Tract 1510.02, Cook, IL",3416,377,2514,343,2514,343,2333,334,181,87,0,11,902,186
14000US17031151100,"Census Tract 1511, Cook, IL",4375,313,3100,279,3100,279,2903,282,197,106,0,15,1275,232
14000US17031151200,"Census Tract 1512, Cook, IL",3096,338,2055,295,2055,295,1904,266,151,104,0,11,1041,159
14000US17031160100,"Census Tract 1601, Cook, IL",2121,258,1468,191,1468,191,1304,167,164,78,0,11,653,133
14000US17031160200,"Census Tract 1602, Cook, IL",2586,243,1751,230,1751,230,1718,224,33,31,0,11,835,225
14000US17031160300,"Census Tract 1603, Cook, IL",3313,280,2389,268,2389,268,2251,257,138,76,0,11,924,221
14000US17031160400,"Census Tract 1604, Cook, IL",3860,317,2651,296,2651,296,2438,261,213,158,0,11,1209,211
14000US17031160501,"Census Tract 1605.01, Cook, IL",3182,393,2240,346,2240,346,2152,340,88,58,0,11,942,186
14000US17031160502,"Census Tract 1605.02, Cook, IL",3118,278,2131,205,2131,205,1985,201,146,101,0,11,987,181
14000US17031160601,"Census Tract 1606.01, Cook, IL",2868,374,2186,300,2174,299,2122,296,52,41,12,19,682,227
14000US17031160602,"Census Tract 1606.02, Cook, IL",2868,279,2180,208,2161,201,2075,196,86,57,19,31,688,166
14000US17031160700,"Census Tract 1607, Cook, IL",5522,642,3720,429,3720,429,3446,465,274,165,0,15,1802,470
14000US17031160800,"Census Tract 1608, Cook, IL",4267,426,3269,384,3269,384,3068,364,201,86,0,15,998,236
14000US17031160900,"Census Tract 1609, Cook, IL",1995,184,1594,165,1584,165,1477,157,107,53,10,16,401,89
14000US17031161000,"Census Tract 1610, Cook, IL",1567,145,1207,140,1207,140,1146,138,61,28,0,11,360,54
14000US17031161100,"Census Tract 1611, Cook, IL",1468,116,1014,97,1014,97,989,94,25,18,0,11,454,93
14000US17031161200,"Census Tract 1612, Cook, IL",2449,230,1604,188,1604,188,1529,178,75,42,0,11,845,118
14000US17031161300,"Census Tract 1613, Cook, IL",3028,415,1984,279,1984,279,1833,270,151,70,0,11,1044,243
14000US17031170100,"Census Tract 1701, Cook, IL",1697,249,693,133,693,133,661,142,32,29,0,11,1004,200
14000US17031170200,"Census Tract 1702, Cook, IL",3304,279,2201,202,2201,202,2093,189,108,68,0,11,1103,193
14000US17031170300,"Census Tract 1703, Cook, IL",4246,437,2929,385,2929,385,2847,392,82,59,0,15,1317,183
14000US17031170400,"Census Tract 1704, Cook, IL",3105,208,1967,165,1967,165,1902,163,65,55,0,11,1138,170
14000US17031170500,"Census Tract 1705, Cook, IL",4552,330,3102,282,3102,282,2919,263,183,104,0,15,1450,255
14000US17031170600,"Census Tract 1706, Cook, IL",2124,169,1351,118,1344,118,1256,110,88,41,7,10,773,137
14000US17031170700,"Census Tract 1707, Cook, IL",2414,262,1538,235,1516,225,1430,222,86,53,22,31,876,167
14000US17031170800,"Census Tract 1708, Cook, IL",3383,239,2339,216,2332,217,2209,207,123,60,7,13,1044,166
14000US17031170900,"Census Tract 1709, Cook, IL",1533,177,1027,149,1027,149,964,115,63,63,0,11,506,104
14000US17031171000,"Census Tract 1710, Cook, IL",6240,504,4219,467,4179,466,3874,410,305,166,40,51,2021,364
14000US17031171100,"Census Tract 1711, Cook, IL",3028,249,2118,246,2118,246,2055,241,63,46,0,11,910,172
14000US17031180100,"Census Tract 1801, Cook, IL",5073,444,3343,476,3343,476,3143,456,200,99,0,15,1730,334
14000US17031190100,"Census Tract 1901, Cook, IL",1917,174,1289,171,1289,171,1177,165,112,51,0,11,628,104
14000US17031190200,"Census Tract 1902, Cook, IL",4108,327,2725,273,2725,273,2579,272,146,78,0,15,1383,218
14000US17031190300,"Census Tract 1903, Cook, IL",4299,397,2926,306,2909,305,2630,294,279,110,17,27,1373,242
14000US17031190401,"Census Tract 1904.01, Cook, IL",3121,296,2134,259,2134,259,1834,238,300,123,0,11,987,210
14000US17031190402,"Census Tract 1904.02, Cook, IL",4281,382,3069,346,3069,346,2732,323,337,156,0,15,1212,219
14000US17031190601,"Census Tract 1906.01, Cook, IL",3670,366,2753,301,2753,301,2498,336,255,108,0,15,917,227
14000US17031190602,"Census Tract 1906.02, Cook, IL",4600,478,3034,436,3034,436,2787,386,247,106,0,15,1566,239
14000US17031190701,"Census Tract 1907.01, Cook, IL",2097,202,1450,192,1450,192,1330,172,120,66,0,11,647,117
14000US17031190702,"Census Tract 1907.02, Cook, IL",3761,353,2666,282,2666,282,2404,276,262,102,0,15,1095,203
14000US17031190800,"Census Tract 1908, Cook, IL",5489,483,3458,379,3458,379,3033,345,425,157,0,15,2031,393
14000US17031190900,"Census Tract 1909, Cook, IL",1707,268,1105,256,1105,256,1079,261,26,26,0,11,602,119
14000US17031191000,"Census Tract 1910, Cook, IL",2022,230,1322,205,1322,205,1179,196,143,66,0,11,700,109
14000US17031191100,"Census Tract 1911, Cook, IL",5689,577,3792,432,3792,432,3517,445,275,141,0,15,1897,317
14000US17031191200,"Census Tract 1912, Cook, IL",2695,274,1890,245,1890,245,1779,232,111,63,0,11,805,138
14000US17031191301,"Census Tract 1913.01, Cook, IL",4050,460,2707,328,2707,328,2441,340,266,105,0,15,1343,291
14000US17031191302,"Census Tract 1913.02, Cook, IL",3896,507,2541,417,2541,417,2227,382,314,156,0,15,1355,259
14000US17031200100,"Census Tract 2001, Cook, IL",3272,385,2347,339,2347,339,2240,340,107,59,0,11,925,189
14000US17031200200,"Census Tract 2002, Cook, IL",4046,355,2719,246,2719,246,2545,253,174,86,0,11,1327,240
14000US17031200300,"Census Tract 2003, Cook, IL",1631,218,1184,185,1184,185,1064,179,120,58,0,11,447,87
14000US17031200401,"Census Tract 2004.01, Cook, IL",2650,217,1876,221,1876,221,1626,228,250,73,0,11,774,149
14000US17031200402,"Census Tract 2004.02, Cook, IL",3154,490,2147,423,2147,423,2047,421,100,59,0,11,1007,224
14000US17031210100,"Census Tract 2101, Cook, IL",2911,268,2033,265,2033,265,1921,261,112,68,0,11,878,229
14000US17031210400,"Census Tract 2104, Cook, IL",2215,208,1422,145,1422,145,1335,144,87,42,0,11,793,147
14000US17031210501,"Census Tract 2105.01, Cook, IL",2831,287,2068,230,2068,230,1887,217,181,89,0,11,763,187
14000US17031210502,"Census Tract 2105.02, Cook, IL",3647,380,2416,278,2416,278,2245,264,171,83,0,11,1231,225
14000US17031210601,"Census Tract 2106.01, Cook, IL",2288,305,1539,229,1539,229,1473,224,66,31,0,11,749,188
14000US17031210602,"Census Tract 2106.02, Cook, IL",3341,375,2336,304,2336,304,2250,311,86,60,0,11,1005,201
14000US17031210700,"Census Tract 2107, Cook, IL",3452,293,2468,252,2468,252,2296,262,172,98,0,11,984,186
14000US17031210800,"Census Tract 2108, Cook, IL",952,119,745,99,745,99,728,98,17,18,0,11,207,74
14000US17031210900,"Census Tract 2109, Cook, IL",2251,284,1795,267,1795,267,1743,266,52,35,0,11,456,139
14000US17031220300,"Census Tract 2203, Cook, IL",1791,149,1537,145,1537,145,1451,143,86,39,0,11,254,56
14000US17031220400,"Census Tract 2204, Cook, IL",2265,273,1781,219,1781,219,1760,218,21,20,0,11,484,176
14000US17031220500,"Census Tract 2205, Cook, IL",2285,190,1885,211,1885,211,1840,213,45,30,0,11,400,113
14000US17031220601,"Census Tract 2206.01, Cook, IL",1456,165,983,134,983,134,948,133,35,25,0,11,473,123
14000US17031220602,"Census Tract 2206.02, Cook, IL",4377,474,3181,398,3181,398,3014,418,167,118,0,15,1196,309
14000US17031220701,"Census Tract 2207.01, Cook, IL",2448,276,2070,265,2070,265,1956,263,114,80,0,11,378,142
14000US17031220702,"Census Tract 2207.02, Cook, IL",2955,348,2251,300,2251,300,2183,288,68,48,0,11,704,232
14000US17031220901,"Census Tract 2209.01, Cook, IL",2252,316,1498,288,1498,288,1372,288,126,79,0,11,754,186
14000US17031220902,"Census Tract 2209.02, Cook, IL",2377,231,1551,175,1551,175,1473,167,78,36,0,11,826,122
14000US17031221000,"Census Tract 2210, Cook, IL",2203,186,1652,179,1652,179,1488,164,164,62,0,11,551,140
14000US17031221100,"Census Tract 2211, Cook, IL",4587,434,3107,330,3107,330,2960,321,147,66,0,15,1480,299
14000US17031221200,"Census Tract 2212, Cook, IL",2773,272,2171,211,2171,211,2071,219,100,59,0,11,602,223
14000US17031221300,"Census Tract 2213, Cook, IL",2533,272,2019,235,2019,235,1902,236,117,60,0,11,514,117
14000US17031221400,"Census Tract 2214, Cook, IL",2489,232,1951,200,1943,200,1892,206,51,40,8,11,538,153
14000US17031221500,"Census Tract 2215, Cook, IL",2405,241,1760,234,1760,234,1677,228,83,59,0,11,645,139
14000US17031221600,"Census Tract 2216, Cook, IL",2593,215,2192,189,2192,189,2141,199,51,44,0,11,401,114
14000US17031222200,"Census Tract 2222, Cook, IL",1747,110,1496,104,1496,104,1437,106,59,34,0,11,251,72
14000US17031222500,"Census Tract 2225, Cook, IL",1378,151,996,126,996,126,929,122,67,42,0,11,382,99
14000US17031222600,"Census Tract 2226, Cook, IL",1308,130,1121,114,1121,114,1060,111,61,27,0,11,187,64
14000US17031222700,"Census Tract 2227, Cook, IL",2110,263,1527,223,1527,223,1442,224,85,47,0,11,583,141
14000US17031222800,"Census Tract 2228, Cook, IL",754,120,441,78,441,78,436,79,5,8,0,11,313,93
14000US17031222900,"Census Tract 2229, Cook, IL",731,136,466,105,466,105,432,101,34,26,0,11,265,82
14000US17031230100,"Census Tract 2301, Cook, IL",1408,183,957,134,957,134,887,133,70,33,0,11,451,112
14000US17031230200,"Census Tract 2302, Cook, IL",1503,210,1068,180,1068,180,957,158,111,61,0,11,435,115
14000US17031230300,"Census Tract 2303, Cook, IL",674,106,409,83,409,83,383,65,26,40,0,11,265,83
14000US17031230400,"Census Tract 2304, Cook, IL",1926,305,1299,238,1299,238,1134,223,165,88,0,11,627,131
14000US17031230500,"Census Tract 2305, Cook, IL",2893,520,1662,339,1662,339,1551,307,111,70,0,11,1231,300
14000US17031230600,"Census Tract 2306, Cook, IL",4710,518,3091,429,3091,429,2457,377,634,252,0,15,1619,273
14000US17031230700,"Census Tract 2307, Cook, IL",4023,458,2630,357,2630,357,2492,347,138,100,0,15,1393,249
14000US17031230800,"Census Tract 2308, Cook, IL",1048,165,724,151,724,151,630,130,94,61,0,11,324,72
14000US17031230900,"Census Tract 2309, Cook, IL",4013,386,2626,324,2626,324,2340,307,286,117,0,15,1387,247
14000US17031231100,"Census Tract 2311, Cook, IL",976,167,696,166,696,166,532,125,164,82,0,11,280,66
14000US17031231200,"Census Tract 2312, Cook, IL",4431,436,2636,360,2636,360,2295,347,341,110,0,15,1795,312
14000US17031231500,"Census Tract 2315, Cook, IL",5072,963,2444,589,2444,589,2105,564,339,188,0,15,2628,771
14000US17031240200,"Census Tract 2402, Cook, IL",1386,137,1151,150,1151,150,1132,152,19,15,0,11,235,51
14000US17031240300,"Census Tract 2403, Cook, IL",1042,115,882,97,882,97,861,97,21,17,0,11,160,61
14000US17031240500,"Census Tract 2405, Cook, IL",2035,141,1857,117,1857,117,1849,117,8,12,0,11,178,108
14000US17031240600,"Census Tract 2406, Cook, IL",1296,187,1134,173,1134,173,1063,155,71,50,0,11,162,56
14000US17031240700,"Census Tract 2407, Cook, IL",1321,130,1007,119,1007,119,941,114,66,34,0,11,314,84
14000US17031240800,"Census Tract 2408, Cook, IL",1291,170,928,118,928,118,850,115,78,40,0,11,363,100
14000US17031240900,"Census Tract 2409, Cook, IL",854,119,578,93,578,93,545,86,33,20,0,11,276,84
14000US17031241000,"Census Tract 2410, Cook, IL",1683,222,1135,168,1135,168,1069,171,66,44,0,11,548,154
14000US17031241100,"Census Tract 2411, Cook, IL",3316,301,2817,272,2817,272,2613,257,204,102,0,11,499,224
14000US17031241200,"Census Tract 2412, Cook, IL",1635,164,1265,152,1265,152,1249,148,16,15,0,11,370,94
14000US17031241300,"Census Tract 2413, Cook, IL",1701,142,1324,113,1324,113,1239,112,85,39,0,11,377,106
14000US17031241400,"Census Tract 2414, Cook, IL",4472,352,3572,348,3572,348,3520,353,52,44,0,15,900,211
14000US17031241500,"Census Tract 2415, Cook, IL",2488,222,2342,202,2342,202,2288,204,54,48,0,11,146,87
14000US17031241600,"Census Tract 2416, Cook, IL",3290,260,2837,227,2837,227,2695,204,142,114,0,11,453,131
14000US17031242000,"Census Tract 2420, Cook, IL",4494,544,3642,531,3642,531,3385,487,257,180,0,15,852,211
14000US17031242100,"Census Tract 2421, Cook, IL",3381,338,3042,282,3042,282,2927,272,115,57,0,11,339,122
14000US17031242200,"Census Tract 2422, Cook, IL",3066,281,2699,240,2699,240,2618,226,81,46,0,11,367,132
14000US17031242300,"Census Tract 2423, Cook, IL",2762,238,2441,264,2441,264,2361,255,80,60,0,11,321,103
14000US17031242400,"Census Tract 2424, Cook, IL",2686,246,2131,234,2131,234,2050,230,81,49,0,11,555,175
14000US17031242500,"Census Tract 2425, Cook, IL",3043,242,2303,227,2303,227,2164,226,139,74,0,11,740,193
14000US17031242600,"Census Tract 2426, Cook, IL",4934,535,3906,443,3906,443,3576,451,330,195,0,15,1028,391
14000US17031242700,"Census Tract 2427, Cook, IL",1350,150,1022,125,1022,125,900,120,122,53,0,11,328,96
14000US17031242800,"Census Tract 2428, Cook, IL",1226,149,945,131,945,131,868,121,77,45,0,11,281,84
14000US17031242900,"Census Tract 2429, Cook, IL",1393,169,1169,126,1169,126,1163,127,6,9,0,11,224,86
14000US17031243000,"Census Tract 2430, Cook, IL",2076,228,1753,260,1753,260,1676,250,77,60,0,11,323,108
14000US17031243100,"Census Tract 2431, Cook, IL",1977,225,1459,181,1459,181,1402,183,57,52,0,11,518,132
14000US17031243200,"Census Tract 2432, Cook, IL",1888,193,1675,158,1675,158,1626,157,49,36,0,11,213,85
14000US17031243300,"Census Tract 2433, Cook, IL",2056,198,1733,192,1733,192,1672,192,61,32,0,11,323,82
14000US17031243400,"Census Tract 2434, Cook, IL",2364,234,1930,185,1930,185,1834,173,96,62,0,11,434,141
14000US17031243500,"Census Tract 2435, Cook, IL",2839,229,2543,238,2543,238,2398,199,145,78,0,11,296,114
14000US17031250200,"Census Tract 2502, Cook, IL",2096,214,1382,170,1382,170,1097,156,285,106,0,11,714,110
14000US17031250300,"Census Tract 2503, Cook, IL",3493,388,2159,373,2159,373,1913,359,246,109,0,11,1334,259
14000US17031250400,"Census Tract 2504, Cook, IL",3494,468,2012,474,2012,474,1748,417,264,135,0,11,1482,269
14000US17031250500,"Census Tract 2505, Cook, IL",6118,365,4426,298,4426,298,3951,278,475,220,0,15,1692,312
14000US17031250600,"Census Tract 2506, Cook, IL",3525,340,2058,230,2058,230,1771,227,287,101,0,11,1467,263
14000US17031250700,"Census Tract 2507, Cook, IL",4316,614,2554,463,2554,463,2234,363,320,231,0,15,1762,333
14000US17031250800,"Census Tract 2508, Cook, IL",1789,215,1018,173,1018,173,872,154,146,75,0,11,771,122
14000US17031251000,"Census Tract 2510, Cook, IL",726,118,424,101,424,101,342,74,82,57,0,11,302,80
14000US17031251100,"Census Tract 2511, Cook, IL",3246,408,1368,309,1368,309,1186,295,182,94,0,11,1878,257
14000US17031251200,"Census Tract 2512, Cook, IL",3560,434,2016,304,2016,304,1607,266,409,132,0,11,1544,261
14000US17031251300,"Census Tract 2513, Cook, IL",3782,401,1960,296,1960,296,1539,271,421,138,0,11,1822,258
14000US17031251400,"Census Tract 2514, Cook, IL",3632,645,1870,272,1870,272,1654,270,216,100,0,11,1762,554
14000US17031251500,"Census Tract 2515, Cook, IL",3408,496,1804,321,1804,321,1375,292,429,161,0,11,1604,336
14000US17031251600,"Census Tract 2516, Cook, IL",3108,512,1346,268,1346,268,1197,254,149,146,0,11,1762,408
14000US17031251700,"Census Tract 2517, Cook, IL",979,169,486,144,486,144,390,121,96,58,0,11,493,108
14000US17031251800,"Census Tract 2518, Cook, IL",3510,451,1922,344,1922,344,1557,276,365,185,0,15,1588,256
14000US17031251900,"Census Tract 2519, Cook, IL",3335,444,1821,285,1821,285,1286,255,535,158,0,11,1514,300
14000US17031252000,"Census Tract 2520, Cook, IL",4572,622,2415,449,2415,449,2238,407,177,114,0,15,2157,398
14000US17031252101,"Census Tract 2521.01, Cook, IL",1111,203,605,147,605,147,531,135,74,62,0,11,506,126
14000US17031252102,"Census Tract 2521.02, Cook, IL",5076,784,2952,541,2952,541,2590,478,362,198,0,15,2124,646
14000US17031252201,"Census Tract 2522.01, Cook, IL",2488,293,1049,183,1049,183,824,145,225,88,0,11,1439,226
14000US17031252202,"Census Tract 2522.02, Cook, IL",3341,476,1654,354,1654,354,1295,262,359,192,0,11,1687,356
14000US17031260100,"Census Tract 2601, Cook, IL",962,148,500,128,500,128,398,98,102,65,0,11,462,89
14000US17031260200,"Census Tract 2602, Cook, IL",865,183,441,125,441,125,351,83,90,58,0,11,424,114
14000US17031260300,"Census Tract 2603, Cook, IL",1201,220,628,139,628,139,470,116,158,139,0,11,573,202
14000US17031260400,"Census Tract 2604, Cook, IL",877,166,434,90,434,90,329,98,105,64,0,11,443,153
14000US17031260500,"Census Tract 2605, Cook, IL",1167,186,520,137,520,137,448,116,72,49,0,11,647,144
14000US17031260600,"Census Tract 2606, Cook, IL",1295,253,574,161,574,161,393,125,181,83,0,11,721,202
14000US17031260700,"Census Tract 2607, Cook, IL",1176,191,464,108,464,108,399,96,65,42,0,11,712,165
14000US17031260800,"Census Tract 2608, Cook, IL",1949,284,863,128,863,128,702,130,161,85,0,11,1086,252
14000US17031260900,"Census Tract 2609, Cook, IL",964,228,465,125,465,125,371,116,94,58,0,11,499,170
14000US17031261000,"Census Tract 2610, Cook, IL",1796,258,813,184,813,184,702,172,111,54,0,11,983,195
14000US17031270500,"Census Tract 2705, Cook, IL",1240,156,648,117,648,117,497,112,151,53,0,11,592,108
14000US17031271200,"Census Tract 2712, Cook, IL",959,184,371,75,371,75,304,67,67,34,0,11,588,167
14000US17031271300,"Census Tract 2713, Cook, IL",763,139,465,123,465,123,380,117,85,46,0,11,298,87
14000US17031271400,"Census Tract 2714, Cook, IL",1028,165,499,119,499,119,424,132,75,54,0,11,529,125
14000US17031271500,"Census Tract 2715, Cook, IL",1118,183,611,110,611,110,540,95,71,41,0,11,507,135
14000US17031271800,"Census Tract 2718, Cook, IL",487,168,201,101,201,101,167,90,34,29,0,11,286,142
14000US17031280100,"Census Tract 2801, Cook, IL",6255,497,5588,469,5572,468,5393,453,179,128,16,25,667,218
14000US17031280400,"Census Tract 2804, Cook, IL",1160,172,647,97,647,97,542,97,105,64,0,11,513,162
14000US17031280800,"Census Tract 2808, Cook, IL",847,143,506,122,506,122,366,109,140,76,0,11,341,71
14000US17031280900,"Census Tract 2809, Cook, IL",674,112,457,93,457,93,321,71,136,54,0,11,217,96
14000US17031281900,"Census Tract 2819, Cook, IL",5367,517,4093,429,4093,429,3923,377,170,110,0,15,1274,337
14000US17031282700,"Census Tract 2827, Cook, IL",1786,268,1201,236,1201,236,1037,192,164,97,0,11,585,145
14000US17031282800,"Census Tract 2828, Cook, IL",1440,147,1009,132,1009,132,927,137,82,42,0,11,431,97
14000US17031283100,"Census Tract 2831, Cook, IL",2519,311,1581,240,1581,240,1477,237,104,53,0,11,938,224
14000US17031283200,"Census Tract 2832, Cook, IL",1382,149,936,140,936,140,878,136,58,35,0,11,446,136
14000US17031283800,"Census Tract 2838, Cook, IL",2994,317,2120,230,2120,230,1813,201,307,142,0,11,874,181
14000US17031290900,"Census Tract 2909, Cook, IL",3016,335,1531,288,1531,288,1029,256,502,175,0,11,1485,302
14000US17031291200,"Census Tract 2912, Cook, IL",1864,247,1048,184,1048,184,756,163,292,78,0,11,816,183
14000US17031291600,"Census Tract 2916, Cook, IL",791,165,540,173,540,173,532,173,8,12,0,11,251,97
14000US17031292200,"Census Tract 2922, Cook, IL",2244,277,1070,157,1070,157,786,134,284,101,0,11,1174,226
14000US17031292400,"Census Tract 2924, Cook, IL",1907,453,840,194,840,194,769,194,71,47,0,11,1067,412
14000US17031292500,"Census Tract 2925, Cook, IL",3077,367,1797,302,1797,302,1435,276,362,115,0,11,1280,299
14000US17031300500,"Census Tract 3005, Cook, IL",2090,244,1307,192,1307,192,1221,172,86,50,0,11,783,162
14000US17031300600,"Census Tract 3006, Cook, IL",2341,339,1329,214,1329,214,1167,192,162,75,0,11,1012,208
14000US17031300700,"Census Tract 3007, Cook, IL",3415,380,2066,287,2066,287,1940,291,126,93,0,11,1349,273
14000US17031300800,"Census Tract 3008, Cook, IL",2817,400,1583,247,1583,247,1418,215,165,87,0,11,1234,260
14000US17031300900,"Census Tract 3009, Cook, IL",3279,421,1974,319,1974,319,1925,312,49,49,0,11,1305,248
14000US17031301100,"Census Tract 3011, Cook, IL",1796,210,1169,158,1169,158,1012,148,157,63,0,11,627,141
14000US17031301200,"Census Tract 3012, Cook, IL",2278,330,1407,252,1407,252,1211,252,196,108,0,11,871,181
14000US17031301600,"Census Tract 3016, Cook, IL",3533,380,2074,347,2074,347,1847,336,227,106,0,15,1459,299
14000US17031301701,"Census Tract 3017.01, Cook, IL",2722,427,1735,366,1735,366,1614,318,121,115,0,11,987,198
14000US17031301702,"Census Tract 3017.02, Cook, IL",3235,375,2000,319,2000,319,1852,319,148,67,0,11,1235,224
14000US17031301801,"Census Tract 3018.01, Cook, IL",2755,361,1698,269,1698,269,1591,251,107,68,0,11,1057,228
14000US17031301802,"Census Tract 3018.02, Cook, IL",2431,280,1454,220,1454,220,1266,197,188,87,0,11,977,132
14000US17031301803,"Census Tract 3018.03, Cook, IL",3949,399,2577,327,2577,327,2404,311,173,112,0,15,1372,240
14000US17031310200,"Census Tract 3102, Cook, IL",1241,134,909,124,909,124,879,121,30,24,0,11,332,96
14000US17031310300,"Census Tract 3103, Cook, IL",1444,212,1017,167,1017,167,849,133,168,116,0,11,427,112
14000US17031310400,"Census Tract 3104, Cook, IL",950,152,590,115,590,115,586,114,4,7,0,11,360,95
14000US17031310500,"Census Tract 3105, Cook, IL",1135,201,797,190,797,190,760,187,37,39,0,11,338,125
14000US17031310600,"Census Tract 3106, Cook, IL",3870,646,2396,408,2396,408,2316,376,80,86,0,11,1474,507
14000US17031310700,"Census Tract 3107, Cook, IL",1287,200,869,171,869,171,784,164,85,48,0,11,418,106
14000US17031310800,"Census Tract 3108, Cook, IL",3581,531,2394,400,2394,400,2296,373,98,73,0,11,1187,310
14000US17031310900,"Census Tract 3109, Cook, IL",4002,421,2711,329,2711,329,2418,298,293,119,0,15,1291,263
14000US17031320100,"Census Tract 3201, Cook, IL",11945,1036,8401,776,8377,775,8045,746,332,244,24,18,3544,767
14000US17031320400,"Census Tract 3204, Cook, IL",3128,350,1415,270,1415,270,1288,257,127,67,0,11,1713,282
14000US17031320600,"Census Tract 3206, Cook, IL",4282,402,3554,408,3554,408,3362,415,192,134,0,11,728,184
14000US17031330100,"Census Tract 3301, Cook, IL",16399,1160,14003,1212,14003,1212,13567,1213,436,266,0,17,2396,528
14000US17031330200,"Census Tract 3302, Cook, IL",3127,187,2070,207,2058,205,2018,207,40,52,12,21,1057,216
14000US17031340300,"Census Tract 3403, Cook, IL",1511,173,790,152,790,152,688,140,102,40,0,11,721,122
14000US17031340400,"Census Tract 3404, Cook, IL",1839,201,1130,178,1130,178,1039,167,91,51,0,11,709,157
14000US17031340500,"Census Tract 3405, Cook, IL",1459,146,825,105,825,105,725,98,100,56,0,11,634,114
14000US17031340600,"Census Tract 3406, Cook, IL",707,97,334,80,334,80,184,53,150,67,0,11,373,80
14000US17031350100,"Census Tract 3501, Cook, IL",2147,199,1340,149,1340,149,1234,141,106,66,0,11,807,189
14000US17031350400,"Census Tract 3504, Cook, IL",1176,117,588,100,588,100,345,81,243,88,0,11,588,95
14000US17031351000,"Census Tract 3510, Cook, IL",3535,340,2402,282,2402,282,2179,262,223,137,0,11,1133,326
14000US17031351100,"Census Tract 3511, Cook, IL",1330,109,678,129,678,129,459,107,219,105,0,11,652,166
14000US17031351400,"Census Tract 3514, Cook, IL",1409,192,904,177,904,177,534,113,370,148,0,11,505,99
14000US17031351500,"Census Tract 3515, Cook, IL",447,110,270,75,270,75,212,63,58,33,0,11,177,79
14000US17031360200,"Census Tract 3602, Cook, IL",1088,171,659,103,659,103,502,89,157,65,0,11,429,136
14000US17031380100,"Census Tract 3801, Cook, IL",1538,236,734,163,734,163,563,142,171,65,0,11,804,144
14000US17031380200,"Census Tract 3802, Cook, IL",1684,185,625,145,625,145,584,127,41,39,0,11,1059,172
14000US17031380500,"Census Tract 3805, Cook, IL",581,126,353,106,353,106,249,79,104,56,0,11,228,54
14000US17031380700,"Census Tract 3807, Cook, IL",1108,203,599,137,599,137,490,92,109,69,0,11,509,165
14000US17031381200,"Census Tract 3812, Cook, IL",1490,181,1068,174,1068,174,1015,167,53,50,0,11,422,148
14000US17031381400,"Census Tract 3814, Cook, IL",1226,240,863,174,863,174,746,175,117,79,0,11,363,115
14000US17031381500,"Census Tract 3815, Cook, IL",257,117,177,108,177,108,151,104,26,31,0,11,80,37
14000US17031381700,"Census Tract 3817, Cook, IL",0,11,0,11,0,11,0,11,0,11,0,11,0,11
14000US17031381800,"Census Tract 3818, Cook, IL",916,138,597,146,585,143,542,141,43,32,12,19,319,69
14000US17031381900,"Census Tract 3819, Cook, IL",1054,166,641,174,641,174,568,157,73,44,0,11,413,84
14000US17031390100,"Census Tract 3901, Cook, IL",1104,122,778,100,778,100,742,106,36,35,0,11,326,80
14000US17031390200,"Census Tract 3902, Cook, IL",1378,145,1051,126,1051,126,950,120,101,56,0,11,327,97
14000US17031390300,"Census Tract 3903, Cook, IL",2033,254,1294,213,1294,213,1026,180,268,137,0,11,739,174
14000US17031390400,"Census Tract 3904, Cook, IL",2191,330,1287,294,1287,294,1111,265,176,79,0,11,904,185
14000US17031390500,"Census Tract 3905, Cook, IL",1232,116,842,107,842,107,779,110,63,34,0,11,390,75
14000US17031390600,"Census Tract 3906, Cook, IL",1502,129,1060,130,1060,130,992,125,68,48,0,11,442,96
14000US17031390700,"Census Tract 3907, Cook, IL",5031,429,2704,412,2704,412,2439,434,265,158,0,15,2327,407
14000US17031400300,"Census Tract 4003, Cook, IL",877,120,603,119,603,119,463,86,140,90,0,11,274,52
14000US17031400400,"Census Tract 4004, Cook, IL",1416,232,911,197,911,197,643,144,268,132,0,11,505,117
14000US17031400500,"Census Tract 4005, Cook, IL",1275,190,803,145,803,145,588,111,215,115,0,11,472,111
14000US17031400800,"Census Tract 4008, Cook, IL",1890,345,1022,217,1022,217,879,226,143,74,0,11,868,243
14000US17031410100,"Census Tract 4101, Cook, IL",1846,180,1299,173,1299,173,1175,185,124,69,0,11,547,122
14000US17031410200,"Census Tract 4102, Cook, IL",1411,148,744,98,744,98,678,95,66,41,0,11,667,121
14000US17031410500,"Census Tract 4105, Cook, IL",2253,244,1405,207,1405,207,1286,207,119,78,0,11,848,206
14000US17031410600,"Census Tract 4106, Cook, IL",2304,273,1370,202,1370,202,1314,191,56,43,0,11,934,249
14000US17031410700,"Census Tract 4107, Cook, IL",1793,216,1233,206,1233,206,1127,199,106,62,0,11,560,134
14000US17031410800,"Census Tract 4108, Cook, IL",2542,274,1571,223,1562,224,1464,221,98,64,9,15,971,185
14000US17031410900,"Census Tract 4109, Cook, IL",2632,200,1792,188,1792,188,1703,193,89,49,0,11,840,147
14000US17031411000,"Census Tract 4110, Cook, IL",3041,328,1836,256,1836,256,1720,244,116,71,0,11,1205,228
14000US17031411100,"Census Tract 4111, Cook, IL",1889,188,1188,135,1188,135,1161,126,27,28,0,11,701,117
14000US17031411200,"Census Tract 4112, Cook, IL",1427,125,910,101,910,101,867,105,43,38,0,11,517,85
14000US17031420100,"Census Tract 4201, Cook, IL",1096,104,539,92,539,92,506,91,33,31,0,11,557,103
14000US17031420200,"Census Tract 4202, Cook, IL",1306,225,667,109,667,109,583,85,84,58,0,11,639,212
14000US17031420300,"Census Tract 4203, Cook, IL",2439,220,1184,171,1184,171,998,162,186,70,0,11,1255,162
14000US17031420400,"Census Tract 4204, Cook, IL",1006,119,528,107,528,107,453,94,75,35,0,11,478,101
14000US17031420500,"Census Tract 4205, Cook, IL",1304,271,691,220,691,220,500,176,191,96,0,11,613,146
14000US17031420600,"Census Tract 4206, Cook, IL",1520,162,781,130,781,130,568,120,213,72,0,11,739,132
14000US17031420700,"Census Tract 4207, Cook, IL",2362,401,1060,254,1060,254,696,177,364,158,0,11,1302,340
14000US17031420800,"Census Tract 4208, Cook, IL",1430,207,905,168,905,168,790,159,115,61,0,11,525,120
14000US17031421200,"Census Tract 4212, Cook, IL",1094,181,607,156,607,156,511,148,96,65,0,11,487,109
14000US17031430101,"Census Tract 4301.01, Cook, IL",2926,385,1839,270,1839,270,1451,247,388,146,0,11,1087,278
14000US17031430102,"Census Tract 4301.02, Cook, IL",2631,281,1487,296,1487,296,1338,267,149,92,0,11,1144,204
14000US17031430200,"Census Tract 4302, Cook, IL",3755,475,2091,398,2091,398,1746,308,345,190,0,11,1664,367
14000US17031430300,"Census Tract 4303, Cook, IL",1459,164,748,156,748,156,550,141,198,86,0,11,711,160
14000US17031430400,"Census Tract 4304, Cook, IL",2103,350,1122,208,1122,208,896,200,226,125,0,11,981,243
14000US17031430500,"Census Tract 4305, Cook, IL",2618,278,1477,246,1477,246,1191,221,286,138,0,11,1141,257
14000US17031430600,"Census Tract 4306, Cook, IL",1361,175,778,127,778,127,662,111,116,65,0,11,583,127
14000US17031430700,"Census Tract 4307, Cook, IL",2062,275,1102,193,1102,193,936,206,166,88,0,11,960,210
14000US17031430800,"Census Tract 4308, Cook, IL",1345,172,862,161,862,161,714,134,148,81,0,11,483,100
14000US17031430900,"Census Tract 4309, Cook, IL",1105,138,590,107,590,107,499,102,91,45,0,11,515,104
14000US17031431200,"Census Tract 4312, Cook, IL",2471,253,1594,231,1594,231,1359,277,235,127,0,11,877,163
14000US17031431301,"Census Tract 4313.01, Cook, IL",2486,401,1483,329,1483,329,1025,214,458,222,0,11,1003,231
14000US17031431302,"Census Tract 4313.02, Cook, IL",2899,481,1833,421,1833,421,1361,362,472,188,0,11,1066,212
14000US17031431400,"Census Tract 4314, Cook, IL",5434,469,2979,389,2979,389,2405,336,574,233,0,15,2455,381
14000US17031440101,"Census Tract 4401.01, Cook, IL",2883,350,1829,293,1829,293,1399,241,430,142,0,11,1054,263
14000US17031440102,"Census Tract 4401.02, Cook, IL",2547,357,1762,295,1762,295,1505,315,257,120,0,11,785,241
14000US17031440201,"Census Tract 4402.01, Cook, IL",3802,530,2454,554,2454,554,1945,434,509,350,0,11,1348,346
14000US17031440202,"Census Tract 4402.02, Cook, IL",2946,300,1822,292,1822,292,1593,279,229,132,0,11,1124,175
14000US17031440300,"Census Tract 4403, Cook, IL",4061,440,2542,421,2542,421,2005,318,537,283,0,11,1519,305
14000US17031440600,"Census Tract 4406, Cook, IL",1661,217,990,213,990,213,833,168,157,123,0,11,671,92
14000US17031440700,"Census Tract 4407, Cook, IL",1242,152,694,120,694,120,509,107,185,85,0,11,548,160
14000US17031440800,"Census Tract 4408, Cook, IL",1219,161,640,120,640,120,512,108,128,58,0,11,579,130
14000US17031440900,"Census Tract 4409, Cook, IL",1828,268,1060,227,1060,227,945,201,115,75,0,11,768,160
14000US17031450300,"Census Tract 4503, Cook, IL",3006,323,1738,279,1738,279,1434,220,304,200,0,11,1268,225
14000US17031460100,"Census Tract 4601, Cook, IL",2327,362,1570,294,1570,294,1112,216,458,174,0,11,757,186
14000US17031460200,"Census Tract 4602, Cook, IL",1964,285,1232,215,1232,215,1028,187,204,94,0,11,732,180
14000US17031460301,"Census Tract 4603.01, Cook, IL",2171,254,1347,240,1347,240,1108,228,239,93,0,11,824,148
14000US17031460302,"Census Tract 4603.02, Cook, IL",2648,338,1439,336,1439,336,986,257,453,178,0,11,1209,218
14000US17031460400,"Census Tract 4604, Cook, IL",2706,405,1511,348,1511,348,1310,313,201,97,0,11,1195,222
14000US17031460500,"Census Tract 4605, Cook, IL",4189,527,2589,474,2589,474,2243,430,346,245,0,11,1600,298
14000US17031460600,"Census Tract 4606, Cook, IL",826,130,459,89,459,89,363,76,96,47,0,11,367,106
14000US17031460700,"Census Tract 4607, Cook, IL",1792,313,1183,244,1183,244,854,173,329,136,0,11,609,173
14000US17031461000,"Census Tract 4610, Cook, IL",1247,148,445,144,445,144,367,136,78,39,0,11,802,109
14000US17031470100,"Census Tract 4701, Cook, IL",1953,354,1116,268,1116,268,867,234,249,126,0,11,837,184
14000US17031480100,"Census Tract 4801, Cook, IL",1980,164,1024,179,1024,179,923,179,101,53,0,11,956,120
14000US17031480200,"Census Tract 4802, Cook, IL",992,166,510,112,510,112,433,109,77,39,0,11,482,103
14000US17031480300,"Census Tract 4803, Cook, IL",1013,144,509,129,509,129,392,107,117,83,0,11,504,105
14000US17031480400,"Census Tract 4804, Cook, IL",5035,423,2938,390,2938,390,2629,346,309,156,0,15,2097,401
14000US17031480500,"Census Tract 4805, Cook, IL",2590,334,1467,250,1467,250,1275,219,192,98,0,11,1123,217
14000US17031490300,"Census Tract 4903, Cook, IL",1808,160,960,118,960,118,896,111,64,45,0,11,848,129
14000US17031490400,"Census Tract 4904, Cook, IL",774,171,472,136,472,136,402,112,70,43,0,11,302,88
14000US17031490500,"Census Tract 4905, Cook, IL",1711,204,994,123,994,123,784,127,210,81,0,11,717,156
14000US17031490600,"Census Tract 4906, Cook, IL",1327,231,626,100,626,100,460,95,166,82,0,11,701,205
14000US17031490700,"Census Tract 4907, Cook, IL",2250,211,1260,178,1260,178,867,131,393,119,0,11,990,151
14000US17031490800,"Census Tract 4908, Cook, IL",3503,405,1996,316,1996,316,1510,220,486,245,0,11,1507,284
14000US17031490901,"Census Tract 4909.01, Cook, IL",3037,455,1901,427,1901,427,1404,297,497,218,0,11,1136,216
14000US17031490902,"Census Tract 4909.02, Cook, IL",4133,422,2029,301,2029,301,1668,295,361,130,0,11,2104,299
14000US17031491000,"Census Tract 4910, Cook, IL",3333,452,1986,398,1986,398,1207,321,779,235,0,11,1347,300
14000US17031491100,"Census Tract 4911, Cook, IL",3758,425,1898,259,1861,253,1556,258,305,96,37,61,1860,327
14000US17031491200,"Census Tract 4912, Cook, IL",1640,181,868,143,868,143,668,104,200,83,0,11,772,100
14000US17031491300,"Census Tract 4913, Cook, IL",1894,315,1017,210,1017,210,674,174,343,129,0,11,877,192
14000US17031491400,"Census Tract 4914, Cook, IL",2316,443,1450,444,1450,444,1009,324,441,201,0,11,866,233
14000US17031500100,"Census Tract 5001, Cook, IL",2700,289,1610,257,1610,257,1449,222,161,100,0,11,1090,195
14000US17031500200,"Census Tract 5002, Cook, IL",1540,195,1100,171,1100,171,779,126,321,108,0,11,440,98
14000US17031500300,"Census Tract 5003, Cook, IL",1236,125,815,106,815,106,683,86,132,49,0,11,421,78
14000US17031510100,"Census Tract 5101, Cook, IL",2419,281,1406,231,1406,231,1140,240,266,101,0,11,1013,204
14000US17031510200,"Census Tract 5102, Cook, IL",2451,254,1375,180,1375,180,1109,130,266,121,0,11,1076,165
14000US17031510300,"Census Tract 5103, Cook, IL",4201,394,2338,361,2338,361,1744,270,594,196,0,15,1863,354
14000US17031520100,"Census Tract 5201, Cook, IL",1446,251,887,160,887,160,788,148,99,45,0,11,559,143
14000US17031520200,"Census Tract 5202, Cook, IL",2617,402,1652,290,1652,290,1271,235,381,160,0,11,965,260
14000US17031520300,"Census Tract 5203, Cook, IL",4338,337,2753,310,2753,310,2087,245,666,213,0,15,1585,214
14000US17031520400,"Census Tract 5204, Cook, IL",3328,351,2164,269,2164,269,1806,246,358,140,0,11,1164,223
14000US17031520500,"Census Tract 5205, Cook, IL",3873,285,2467,286,2439,281,2123,251,316,138,28,43,1406,187
14000US17031520600,"Census Tract 5206, Cook, IL",2155,286,1151,205,1151,205,970,175,181,103,0,11,1004,174
14000US17031530100,"Census Tract 5301, Cook, IL",1778,230,1164,217,1164,217,942,170,222,84,0,11,614,129
14000US17031530200,"Census Tract 5302, Cook, IL",3094,435,1743,296,1743,296,1218,217,525,171,0,11,1351,289
14000US17031530300,"Census Tract 5303, Cook, IL",3615,374,2399,290,2399,290,1769,239,630,150,0,11,1216,224
14000US17031530400,"Census Tract 5304, Cook, IL",1600,150,997,138,997,138,795,106,202,74,0,11,603,88
14000US17031530501,"Census Tract 5305.01, Cook, IL",3560,421,1866,332,1866,332,1552,287,314,151,0,11,1694,268
14000US17031530502,"Census Tract 5305.02, Cook, IL",1201,143,768,112,768,112,587,98,181,61,0,11,433,72
14000US17031530503,"Census Tract 5305.03, Cook, IL",4413,419,2644,413,2644,413,1804,293,840,240,0,15,1769,237
14000US17031530600,"Census Tract 5306, Cook, IL",2072,423,1309,232,1309,232,982,174,327,157,0,11,763,350
14000US17031540101,"Census Tract 5401.01, Cook, IL",2406,289,1515,257,1515,257,936,214,579,192,0,11,891,222
14000US17031540102,"Census Tract 5401.02, Cook, IL",2145,236,1227,215,1227,215,830,180,397,118,0,11,918,130
14000US17031550100,"Census Tract 5501, Cook, IL",5525,730,3420,611,3420,611,3141,662,279,213,0,15,2105,343
14000US17031550200,"Census Tract 5502, Cook, IL",2128,185,1240,141,1240,141,1131,116,109,66,0,11,888,165
14000US17031560100,"Census Tract 5601, Cook, IL",1288,199,693,117,693,117,636,106,57,36,0,11,595,144
14000US17031560200,"Census Tract 5602, Cook, IL",1498,182,895,148,895,148,628,101,267,127,0,11,603,121
14000US17031560300,"Census Tract 5603, Cook, IL",2528,303,1482,175,1482,175,1321,172,161,89,0,11,1046,210
14000US17031560400,"Census Tract 5604, Cook, IL",1336,134,845,168,845,168,741,151,104,61,0,11,491,98
14000US17031560700,"Census Tract 5607, Cook, IL",2725,315,1869,244,1869,244,1636,206,233,98,0,11,856,181
14000US17031560800,"Census Tract 5608, Cook, IL",4758,396,3091,329,3091,329,2748,274,343,242,0,15,1667,262
14000US17031560900,"Census Tract 5609, Cook, IL",4440,312,2906,315,2906,315,2803,304,103,70,0,15,1534,199
14000US17031561000,"Census Tract 5610, Cook, IL",4536,310,3112,306,3112,306,2922,317,190,99,0,15,1424,252
14000US17031561100,"Census Tract 5611, Cook, IL",4424,280,2879,210,2879,210,2667,201,212,92,0,15,1545,177
14000US17031570100,"Census Tract 5701, Cook, IL",1001,139,727,119,727,119,675,110,52,35,0,11,274,68
14000US17031570200,"Census Tract 5702, Cook, IL",1666,198,1016,141,1016,141,887,144,129,60,0,11,650,142
14000US17031570300,"Census Tract 5703, Cook, IL",4121,370,2804,322,2804,322,2517,299,287,122,0,15,1317,200
14000US17031570400,"Census Tract 5704, Cook, IL",1374,179,938,126,938,126,829,131,109,61,0,11,436,99
14000US17031570500,"Census Tract 5705, Cook, IL",1730,195,1089,145,1089,145,1061,141,28,32,0,11,641,148
14000US17031580100,"Census Tract 5801, Cook, IL",2179,214,1399,165,1391,163,1225,149,166,74,8,12,780,130
14000US17031580200,"Census Tract 5802, Cook, IL",2553,288,1561,218,1561,218,1418,198,143,68,0,11,992,206
14000US17031580300,"Census Tract 5803, Cook, IL",2075,274,1291,194,1291,194,1158,203,133,89,0,11,784,184
14000US17031580400,"Census Tract 5804, Cook, IL",3358,347,2052,312,2052,312,1995,311,57,51,0,11,1306,240
14000US17031580501,"Census Tract 5805.01, Cook, IL",3512,389,2268,340,2268,340,2028,292,240,132,0,11,1244,204
14000US17031580502,"Census Tract 5805.02, Cook, IL",3973,423,2686,322,2686,322,2424,320,262,111,0,15,1287,277
14000US17031580600,"Census Tract 5806, Cook, IL",3881,383,2639,287,2639,287,2273,281,366,103,0,15,1242,227
14000US17031580700,"Census Tract 5807, Cook, IL",4643,518,2879,351,2879,351,2450,338,429,138,0,15,1764,276
14000US17031580800,"Census Tract 5808, Cook, IL",1630,231,1109,194,1109,194,947,173,162,96,0,11,521,112
14000US17031590500,"Census Tract 5905, Cook, IL",1513,156,994,117,994,117,855,119,139,77,0,11,519,99
14000US17031590600,"Census Tract 5906, Cook, IL",2664,265,1821,238,1821,238,1543,173,278,139,0,11,843,182
14000US17031590700,"Census Tract 5907, Cook, IL",2391,306,1617,201,1617,201,1509,199,108,56,0,11,774,222
14000US17031600400,"Census Tract 6004, Cook, IL",3831,284,2564,264,2564,264,2242,286,322,150,0,11,1267,254
14000US17031600600,"Census Tract 6006, Cook, IL",2370,303,1540,251,1540,251,1443,220,97,58,0,11,830,151
14000US17031600700,"Census Tract 6007, Cook, IL",2298,319,1450,388,1450,388,1184,329,266,123,0,11,848,274
14000US17031600900,"Census Tract 6009, Cook, IL",3081,346,2089,283,2089,283,1927,283,162,87,0,11,992,221
14000US17031610300,"Census Tract 6103, Cook, IL",4047,480,2610,330,2610,330,2213,291,397,132,0,15,1437,287
14000US17031610400,"Census Tract 6104, Cook, IL",1362,210,966,148,966,148,775,126,191,98,0,11,396,116
14000US17031610800,"Census Tract 6108, Cook, IL",1217,146,830,94,830,94,721,97,109,55,0,11,387,85
14000US17031611000,"Census Tract 6110, Cook, IL",664,112,293,82,293,82,236,77,57,38,0,11,371,57
14000US17031611100,"Census Tract 6111, Cook, IL",1713,213,1020,168,1020,168,800,147,220,106,0,11,693,123
14000US17031611200,"Census Tract 6112, Cook, IL",1820,270,939,185,939,185,794,159,145,70,0,11,881,160
14000US17031611300,"Census Tract 6113, Cook, IL",1873,260,1209,238,1209,238,995,210,214,85,0,11,664,128
14000US17031611400,"Census Tract 6114, Cook, IL",2371,341,1465,278,1465,278,1289,262,176,99,0,11,906,185
14000US17031611500,"Census Tract 6115, Cook, IL",2415,342,1295,261,1295,261,1094,229,201,87,0,11,1120,187
14000US17031611600,"Census Tract 6116, Cook, IL",1143,243,737,146,737,146,573,141,164,59,0,11,406,160
14000US17031611700,"Census Tract 6117, Cook, IL",1102,157,652,144,652,144,503,125,149,65,0,11,450,116
14000US17031611800,"Census Tract 6118, Cook, IL",1696,375,1166,314,1166,314,851,266,315,168,0,11,530,161
14000US17031611900,"Census Tract 6119, Cook, IL",1222,207,667,162,667,162,548,137,119,67,0,11,555,122
14000US17031612000,"Census Tract 6120, Cook, IL",1053,147,687,140,687,140,445,100,242,74,0,11,366,91
14000US17031612100,"Census Tract 6121, Cook, IL",832,155,412,118,412,118,258,80,154,68,0,11,420,80
14000US17031620100,"Census Tract 6201, Cook, IL",3639,318,2404,313,2404,313,2072,345,332,130,0,11,1235,211
14000US17031620200,"Census Tract 6202, Cook, IL",1910,206,1395,207,1395,207,1240,192,155,78,0,11,515,123
14000US17031620300,"Census Tract 6203, Cook, IL",5612,427,3715,360,3715,360,3188,355,527,156,0,15,1897,316
14000US17031620400,"Census Tract 6204, Cook, IL",3300,354,2069,288,2069,288,1953,281,116,70,0,11,1231,183
14000US17031630100,"Census Tract 6301, Cook, IL",659,121,446,113,446,113,386,98,60,39,0,11,213,55
14000US17031630200,"Census Tract 6302, Cook, IL",1460,172,933,171,926,169,837,163,89,48,7,11,527,106
14000US17031630300,"Census Tract 6303, Cook, IL",4015,358,2720,316,2720,316,2346,334,374,139,0,15,1295,215
14000US17031630400,"Census Tract 6304, Cook, IL",5122,517,3353,428,3353,428,2892,377,461,142,0,15,1769,231
14000US17031630500,"Census Tract 6305, Cook, IL",4603,551,3202,537,3202,537,2936,507,266,111,0,15,1401,268
14000US17031630800,"Census Tract 6308, Cook, IL",5292,555,3643,403,3643,403,3157,391,486,171,0,15,1649,319
14000US17031630900,"Census Tract 6309, Cook, IL",3613,419,2490,360,2490,360,2166,318,324,143,0,15,1123,256
14000US17031640100,"Census Tract 6401, Cook, IL",1247,189,855,207,855,207,813,202,42,36,0,11,392,81
14000US17031640300,"Census Tract 6403, Cook, IL",5319,416,3657,405,3657,405,3257,309,400,219,0,15,1662,263
14000US17031640400,"Census Tract 6404, Cook, IL",2982,364,1896,252,1896,252,1775,244,121,67,0,11,1086,196
14000US17031640500,"Census Tract 6405, Cook, IL",3120,271,2064,238,2064,238,1930,240,134,78,0,11,1056,171
14000US17031640600,"Census Tract 6406, Cook, IL",3425,312,2257,263,2257,263,1940,237,317,155,0,11,1168,233
14000US17031640700,"Census Tract 6407, Cook, IL",2637,205,1606,169,1606,169,1421,143,185,104,0,11,1031,189
14000US17031640800,"Census Tract 6408, Cook, IL",1361,132,997,133,997,133,850,106,147,67,0,11,364,60
14000US17031650100,"Census Tract 6501, Cook, IL",3237,372,2141,345,2141,345,1863,324,278,112,0,11,1096,221
14000US17031650200,"Census Tract 6502, Cook, IL",5495,593,3748,461,3748,461,3254,413,494,184,0,15,1747,334
14000US17031650301,"Census Tract 6503.01, Cook, IL",3976,354,2728,379,2728,379,2388,320,340,160,0,15,1248,208
14000US17031650302,"Census Tract 6503.02, Cook, IL",3208,344,2256,353,2256,353,2018,322,238,117,0,11,952,159
14000US17031650400,"Census Tract 6504, Cook, IL",5205,491,3270,446,3270,446,2719,362,551,181,0,15,1935,276
14000US17031650500,"Census Tract 6505, Cook, IL",3444,383,2251,268,2251,268,1999,255,252,104,0,11,1193,286
14000US17031660301,"Census Tract 6603.01, Cook, IL",1149,166,827,155,827,155,562,104,265,103,0,11,322,87
14000US17031660302,"Census Tract 6603.02, Cook, IL",3925,477,2617,393,2617,393,2151,358,466,156,0,15,1308,238
14000US17031660400,"Census Tract 6604, Cook, IL",4461,413,3029,379,3029,379,2663,327,366,147,0,15,1432,202
14000US17031660500,"Census Tract 6605, Cook, IL",3650,359,2092,290,2092,290,1801,245,291,162,0,15,1558,238
14000US17031660600,"Census Tract 6606, Cook, IL",4700,508,3029,401,3021,402,2217,310,804,287,8,13,1671,336
14000US17031660700,"Census Tract 6607, Cook, IL",1729,221,1004,197,1004,197,703,149,301,90,0,11,725,109
14000US17031660800,"Census Tract 6608, Cook, IL",3762,351,2518,334,2518,334,2109,292,409,160,0,15,1244,233
14000US17031660900,"Census Tract 6609, Cook, IL",3498,456,2167,348,2167,348,1448,266,719,165,0,11,1331,231
14000US17031661000,"Census Tract 6610, Cook, IL",4208,459,2586,386,2586,386,1689,258,897,275,0,15,1622,208
14000US17031661100,"Census Tract 6611, Cook, IL",4899,376,3429,411,3429,411,2884,382,545,171,0,15,1470,229
14000US17031670100,"Census Tract 6701, Cook, IL",931,163,565,125,565,125,407,111,158,87,0,11,366,111
14000US17031670200,"Census Tract 6702, Cook, IL",688,153,376,116,376,116,291,97,85,56,0,11,312,90
14000US17031670300,"Census Tract 6703, Cook, IL",870,220,494,179,494,179,379,165,115,58,0,11,376,123
14000US17031670400,"Census Tract 6704, Cook, IL",1337,220,708,158,708,158,503,152,205,69,0,11,629,118
14000US17031670500,"Census Tract 6705, Cook, IL",880,131,446,106,446,106,306,85,140,58,0,11,434,79
14000US17031670600,"Census Tract 6706, Cook, IL",923,161,405,104,405,104,206,88,199,86,0,11,518,122
14000US17031670700,"Census Tract 6707, Cook, IL",931,193,497,151,497,151,357,97,140,79,0,11,434,131
14000US17031670800,"Census Tract 6708, Cook, IL",973,158,420,97,420,97,318,85,102,43,0,11,553,145
14000US17031670900,"Census Tract 6709, Cook, IL",1262,227,774,169,774,169,431,99,343,154,0,11,488,114
14000US17031671100,"Census Tract 6711, Cook, IL",645,97,336,83,336,83,258,81,78,48,0,11,309,90
14000US17031671200,"Census Tract 6712, Cook, IL",771,189,417,128,417,128,221,84,196,93,0,11,354,106
14000US17031671300,"Census Tract 6713, Cook, IL",1659,286,953,215,953,215,623,150,330,107,0,11,706,132
14000US17031671400,"Census Tract 6714, Cook, IL",1188,245,585,212,585,212,351,110,234,171,0,11,603,146
14000US17031671500,"Census Tract 6715, Cook, IL",2063,277,1046,134,1046,134,735,129,311,84,0,11,1017,226
14000US17031671600,"Census Tract 6716, Cook, IL",1650,303,891,228,891,228,569,168,322,124,0,11,759,199
14000US17031671800,"Census Tract 6718, Cook, IL",947,203,459,112,459,112,350,99,109,37,0,11,488,139
14000US17031671900,"Census Tract 6719, Cook, IL",906,174,523,126,523,126,409,103,114,58,0,11,383,88
14000US17031672000,"Census Tract 6720, Cook, IL",3281,390,1746,320,1746,320,1235,294,511,169,0,11,1535,263
14000US17031680500,"Census Tract 6805, Cook, IL",992,190,499,119,499,119,293,92,206,101,0,11,493,135
14000US17031680600,"Census Tract 6806, Cook, IL",1056,238,556,137,556,137,355,125,201,67,0,11,500,166
14000US17031680900,"Census Tract 6809, Cook, IL",2356,291,1088,230,1088,230,795,199,293,111,0,11,1268,243
14000US17031681000,"Census Tract 6810, Cook, IL",2192,493,898,230,898,230,678,156,220,142,0,11,1294,383
14000US17031681100,"Census Tract 6811, Cook, IL",2179,377,1164,275,1164,275,665,203,499,176,0,11,1015,253
14000US17031681200,"Census Tract 6812, Cook, IL",1802,268,1134,203,1134,203,728,126,406,163,0,11,668,167
14000US17031681300,"Census Tract 6813, Cook, IL",1610,231,879,164,879,164,549,139,330,116,0,11,731,146
14000US17031681400,"Census Tract 6814, Cook, IL",2032,317,947,202,947,202,677,166,270,110,0,11,1085,228
14000US17031690300,"Census Tract 6903, Cook, IL",1762,223,815,153,815,153,660,128,155,133,0,11,947,163
14000US17031690400,"Census Tract 6904, Cook, IL",2866,332,1630,225,1630,225,1402,198,228,113,0,11,1236,293
14000US17031690500,"Census Tract 6905, Cook, IL",599,102,359,113,359,113,302,102,57,58,0,11,240,75
14000US17031690900,"Census Tract 6909, Cook, IL",3559,457,1819,341,1819,341,1502,297,317,133,0,11,1740,347
14000US17031691000,"Census Tract 6910, Cook, IL",2122,358,1421,310,1421,310,1175,276,246,118,0,11,701,172
14000US17031691100,"Census Tract 6911, Cook, IL",2601,433,1274,271,1274,271,902,181,372,169,0,11,1327,273
14000US17031691200,"Census Tract 6912, Cook, IL",2260,414,1298,320,1298,320,1037,242,261,142,0,11,962,339
14000US17031691300,"Census Tract 6913, Cook, IL",2214,395,1390,350,1390,350,914,256,476,208,0,11,824,166
14000US17031691400,"Census Tract 6914, Cook, IL",2343,259,1407,196,1407,196,1233,198,174,68,0,11,936,204
14000US17031691500,"Census Tract 6915, Cook, IL",1519,169,842,152,842,152,556,127,286,86,0,11,677,125
14000US17031700100,"Census Tract 7001, Cook, IL",2559,222,1816,257,1816,257,1639,260,177,111,0,11,743,251
14000US17031700200,"Census Tract 7002, Cook, IL",4780,383,3101,348,3101,348,2686,324,415,138,0,15,1679,234
14000US17031700301,"Census Tract 7003.01, Cook, IL",4911,312,3302,288,3302,288,2905,304,397,138,0,15,1609,184
14000US17031700302,"Census Tract 7003.02, Cook, IL",4260,312,2834,378,2834,378,2471,330,363,151,0,15,1426,235
14000US17031700401,"Census Tract 7004.01, Cook, IL",4736,423,3311,330,3311,330,2918,293,393,125,0,15,1425,228
14000US17031700402,"Census Tract 7004.02, Cook, IL",3276,231,2282,211,2282,211,1844,214,438,144,0,11,994,172
14000US17031700501,"Census Tract 7005.01, Cook, IL",6163,485,3865,363,3865,363,3513,379,352,198,0,15,2298,473
14000US17031700502,"Census Tract 7005.02, Cook, IL",2656,206,1776,180,1776,180,1407,175,369,140,0,11,880,158
14000US17031710100,"Census Tract 7101, Cook, IL",907,164,560,122,560,122,331,118,229,75,0,11,347,101
14000US17031710200,"Census Tract 7102, Cook, IL",3623,368,2265,296,2265,296,1669,230,596,218,0,11,1358,258
14000US17031710300,"Census Tract 7103, Cook, IL",1100,178,614,111,614,111,390,92,224,77,0,11,486,123
14000US17031710400,"Census Tract 7104, Cook, IL",4335,465,2289,308,2281,309,1734,263,547,181,8,12,2046,366
14000US17031710500,"Census Tract 7105, Cook, IL",3377,397,2119,321,2119,321,1693,258,426,127,0,11,1258,250
14000US17031710600,"Census Tract 7106, Cook, IL",1362,187,694,135,694,135,582,113,112,64,0,11,668,120
14000US17031710700,"Census Tract 7107, Cook, IL",2430,292,1402,273,1402,273,1191,247,211,105,0,11,1028,168
14000US17031710800,"Census Tract 7108, Cook, IL",3952,525,2099,401,2099,401,1687,426,412,190,0,11,1853,392
14000US17031710900,"Census Tract 7109, Cook, IL",1624,192,967,168,967,168,635,122,332,145,0,11,657,123
14000US17031711000,"Census Tract 7110, Cook, IL",2695,444,1334,232,1334,232,1076,219,258,103,0,11,1361,352
14000US17031711100,"Census Tract 7111, Cook, IL",1933,265,1073,213,1073,213,951,196,122,73,0,11,860,154
14000US17031711200,"Census Tract 7112, Cook, IL",4181,335,2405,290,2405,290,2136,267,269,127,0,11,1776,281
14000US17031711300,"Census Tract 7113, Cook, IL",1480,195,791,137,791,137,581,111,210,106,0,11,689,115
14000US17031711400,"Census Tract 7114, Cook, IL",2002,220,969,141,969,141,792,124,177,67,0,11,1033,204
14000US17031711500,"Census Tract 7115, Cook, IL",2124,214,1133,188,1133,188,882,169,251,94,0,11,991,126
14000US17031720100,"Census Tract 7201, Cook, IL",2597,182,1645,163,1645,163,1546,174,99,58,0,11,952,145
14000US17031720200,"Census Tract 7202, Cook, IL",3314,278,2100,264,2100,264,1979,257,121,68,0,11,1214,161
14000US17031720300,"Census Tract 7203, Cook, IL",3317,286,2025,237,2025,237,1904,236,121,61,0,11,1292,180
14000US17031720400,"Census Tract 7204, Cook, IL",1505,122,1074,135,1074,135,980,110,94,56,0,11,431,93
14000US17031720500,"Census Tract 7205, Cook, IL",1692,99,1218,101,1218,101,1204,100,14,17,0,11,474,105
14000US17031720600,"Census Tract 7206, Cook, IL",1334,115,915,96,915,96,859,91,56,29,0,11,419,70
14000US17031720700,"Census Tract 7207, Cook, IL",2625,236,1779,190,1779,190,1617,182,162,133,0,11,846,183
14000US17031730100,"Census Tract 7301, Cook, IL",2190,237,1275,239,1257,233,934,163,323,127,18,24,915,143
14000US17031730201,"Census Tract 7302.01, Cook, IL",4967,507,2676,396,2676,396,2221,355,455,174,0,15,2291,377
14000US17031730202,"Census Tract 7302.02, Cook, IL",2970,353,1769,301,1769,301,1263,231,506,171,0,11,1201,234
14000US17031730300,"Census Tract 7303, Cook, IL",938,109,511,86,511,86,434,87,77,36,0,11,427,81
14000US17031730400,"Census Tract 7304, Cook, IL",3439,344,2204,334,2204,334,1949,332,255,102,0,11,1235,169
14000US17031730500,"Census Tract 7305, Cook, IL",3582,337,2421,344,2421,344,1950,216,471,219,0,11,1161,217
14000US17031730600,"Census Tract 7306, Cook, IL",2949,401,1518,215,1518,215,1340,205,178,93,0,11,1431,338
14000US17031730700,"Census Tract 7307, Cook, IL",1846,202,1031,170,1031,170,852,158,179,77,0,11,815,128
14000US17031740100,"Census Tract 7401, Cook, IL",2410,165,1660,159,1660,159,1593,154,67,48,0,11,750,113
14000US17031740200,"Census Tract 7402, Cook, IL",5254,370,3169,331,3169,331,3118,333,51,45,0,15,2085,351
14000US17031740300,"Census Tract 7403, Cook, IL",3759,265,2522,226,2522,226,2459,226,63,41,0,11,1237,196
14000US17031740400,"Census Tract 7404, Cook, IL",3752,235,2581,274,2581,274,2450,282,131,74,0,11,1171,181
14000US17031750100,"Census Tract 7501, Cook, IL",3439,329,1756,326,1756,326,1515,297,241,123,0,11,1683,242
14000US17031750200,"Census Tract 7502, Cook, IL",2366,206,1612,192,1612,192,1496,182,116,82,0,11,754,146
14000US17031750300,"Census Tract 7503, Cook, IL",1889,112,1218,104,1218,104,1139,90,79,42,0,11,671,105
14000US17031750400,"Census Tract 7504, Cook, IL",2577,168,1902,162,1902,162,1800,177,102,63,0,11,675,139
14000US17031750500,"Census Tract 7505, Cook, IL",4995,516,2420,392,2420,392,1996,343,424,225,0,15,2575,459
14000US17031750600,"Census Tract 7506, Cook, IL",2635,364,1289,264,1289,264,1053,231,236,126,0,11,1346,229
14000US17031760801,"Census Tract 7608.01, Cook, IL",3424,253,2487,271,2487,271,2342,267,145,110,0,11,937,281
14000US17031760802,"Census Tract 7608.02, Cook, IL",2213,244,1229,155,1229,155,1150,173,79,61,0,11,984,172
14000US17031760803,"Census Tract 7608.03, Cook, IL",4735,375,3107,312,3107,312,2806,285,301,154,0,15,1628,316
14000US17031770500,"Census Tract 7705, Cook, IL",2813,333,1956,318,1956,318,1854,316,102,73,0,11,857,276
14000US17031770602,"Census Tract 7706.02, Cook, IL",4205,406,2741,310,2741,310,2544,286,197,124,0,15,1464,280
14000US17031770700,"Census Tract 7707, Cook, IL",2239,183,1587,180,1587,180,1472,188,115,53,0,11,652,137
14000US17031770800,"Census Tract 7708, Cook, IL",4589,332,3152,322,3152,322,2954,324,198,158,0,15,1437,299
14000US17031770902,"Census Tract 7709.02, Cook, IL",3065,218,1648,180,1648,180,1591,189,57,37,0,11,1417,146
14000US17031810400,"Census Tract 8104, Cook, IL",4223,146,2725,164,2725,164,2658,171,67,46,0,15,1498,155
14000US17031823304,"Census Tract 8233.04, Cook, IL",4733,344,3168,318,3162,316,2719,286,443,199,6,10,1565,260
14000US17031830500,"Census Tract 8305, Cook, IL",3283,415,1876,350,1876,350,1706,296,170,110,0,11,1407,199
14000US17031830600,"Census Tract 8306, Cook, IL",3845,434,3221,405,3221,405,3016,372,205,96,0,11,624,133
14000US17031830700,"Census Tract 8307, Cook, IL",3184,318,2379,337,2379,337,2211,298,168,97,0,11,805,197
14000US17031830800,"Census Tract 8308, Cook, IL",2319,203,2079,190,2079,190,1939,181,140,86,0,11,240,77
14000US17031830900,"Census Tract 8309, Cook, IL",2378,228,1927,168,1927,168,1906,169,21,22,0,11,451,177
14000US17031831000,"Census Tract 8310, Cook, IL",1846,170,1658,180,1658,180,1615,177,43,26,0,11,188,60
14000US17031831100,"Census Tract 8311, Cook, IL",6481,809,4236,489,4236,489,4018,517,218,125,0,15,2245,541
14000US17031831200,"Census Tract 8312, Cook, IL",3766,453,2522,360,2522,360,2330,345,192,80,0,15,1244,245
14000US17031831300,"Census Tract 8313, Cook, IL",910,127,496,135,496,135,432,120,64,42,0,11,414,109
14000US17031831400,"Census Tract 8314, Cook, IL",2403,358,1239,215,1239,215,1101,196,138,72,0,11,1164,257
14000US17031831500,"Census Tract 8315, Cook, IL",2811,354,2014,286,2014,286,1867,276,147,96,0,11,797,175
14000US17031831600,"Census Tract 8316, Cook, IL",6008,672,3386,494,3364,489,3063,452,301,133,22,31,2622,377
14000US17031831700,"Census Tract 8317, Cook, IL",1820,205,1370,164,1370,164,1205,145,165,67,0,11,450,94
14000US17031831800,"Census Tract 8318, Cook, IL",5162,469,3568,415,3568,415,3361,423,207,109,0,15,1594,292
14000US17031831900,"Census Tract 8319, Cook, IL",2377,259,2189,255,2189,255,2155,257,34,28,0,11,188,109
14000US17031832000,"Census Tract 8320, Cook, IL",1684,160,1514,146,1514,146,1464,142,50,26,0,11,170,53
14000US17031832100,"Census Tract 8321, Cook, IL",2964,276,2591,265,2591,265,2460,269,131,76,0,11,373,123
14000US17031832200,"Census Tract 8322, Cook, IL",2685,288,2365,240,2365,240,2318,243,47,34,0,11,320,150
14000US17031832300,"Census Tract 8323, Cook, IL",1761,147,1443,112,1438,113,1414,111,24,17,5,9,318,111
14000US17031832400,"Census Tract 8324, Cook, IL",2510,247,1939,225,1939,225,1863,228,76,41,0,11,571,135
14000US17031832500,"Census Tract 8325, Cook, IL",3039,284,2088,204,2088,204,1935,196,153,86,0,11,951,217
14000US17031832600,"Census Tract 8326, Cook, IL",3192,255,2701,252,2701,252,2652,248,49,30,0,11,491,143
14000US17031832900,"Census Tract 8329, Cook, IL",2159,295,1601,266,1601,266,1433,216,168,182,0,11,558,209
14000US17031833000,"Census Tract 8330, Cook, IL",3275,286,2881,279,2881,279,2723,288,158,106,0,11,394,136
14000US17031833100,"Census Tract 8331, Cook, IL",6282,324,4712,312,4712,312,4603,300,109,60,0,15,1570,304
14000US17031833300,"Census Tract 8333, Cook, IL",2477,252,1533,215,1526,216,1404,210,122,62,7,11,944,204
14000US17031833900,"Census Tract 8339, Cook, IL",1831,208,1134,176,1134,176,912,165,222,90,0,11,697,144
14000US17031834000,"Census Tract 8340, Cook, IL",2407,365,1419,241,1419,241,1154,215,265,93,0,11,988,243
14000US17031834200,"Census Tract 8342, Cook, IL",3358,542,2020,444,2020,444,1711,338,309,208,0,11,1338,368
14000US17031834300,"Census Tract 8343, Cook, IL",5324,616,2520,477,2520,477,2064,397,456,184,0,15,2804,375
14000US17031834400,"Census Tract 8344, Cook, IL",3384,424,1997,298,1997,298,1734,274,263,120,0,11,1387,266
14000US17031834500,"Census Tract 8345, Cook, IL",889,142,495,128,495,128,356,111,139,69,0,11,394,144
14000US17031834600,"Census Tract 8346, Cook, IL",1923,387,1096,313,1096,313,692,177,404,219,0,11,827,250
14000US17031834700,"Census Tract 8347, Cook, IL",1224,214,617,143,617,143,439,118,178,75,0,11,607,122
14000US17031834800,"Census Tract 8348, Cook, IL",1283,177,605,111,605,111,380,90,225,77,0,11,678,118
14000US17031834900,"Census Tract 8349, Cook, IL",1487,185,617,138,617,138,437,99,180,75,0,11,870,145
14000US17031835000,"Census Tract 8350, Cook, IL",4215,417,2523,364,2523,364,1908,309,615,188,0,15,1692,264
14000US17031835100,"Census Tract 8351, Cook, IL",4280,404,2906,439,2906,439,2260,324,646,314,0,15,1374,249
14000US17031835200,"Census Tract 8352, Cook, IL",1476,166,959,110,959,110,860,116,99,44,0,11,517,145
14000US17031835500,"Census Tract 8355, Cook, IL",1270,149,560,127,560,127,414,98,146,61,0,11,710,117
14000US17031835600,"Census Tract 8356, Cook, IL",753,163,332,109,332,109,204,82,128,60,0,11,421,105
14000US17031835700,"Census Tract 8357, Cook, IL",340,208,209,158,209,158,15,24,194,157,0,11,131,109
14000US17031835800,"Census Tract 8358, Cook, IL",1138,198,855,144,855,144,663,124,192,83,0,11,283,97
14000US17031835900,"Census Tract 8359, Cook, IL",2545,289,1435,272,1435,272,1039,241,396,179,0,11,1110,220
14000US17031836000,"Census Tract 8360, Cook, IL",1952,188,1497,155,1497,155,1193,139,304,127,0,11,455,129
14000US17031836100,"Census Tract 8361, Cook, IL",1523,253,923,175,923,175,722,169,201,94,0,11,600,156
14000US17031836200,"Census Tract 8362, Cook, IL",1551,456,577,248,577,248,510,228,67,55,0,11,974,288
14000US17031836300,"Census Tract 8363, Cook, IL",1237,197,805,192,805,192,736,191,69,49,0,11,432,161
14000US17031836400,"Census Tract 8364, Cook, IL",2495,200,1689,199,1689,199,1401,186,288,108,0,11,806,115
14000US17031836500,"Census Tract 8365, Cook, IL",1334,172,892,150,892,150,606,152,286,119,0,11,442,127
14000US17031836600,"Census Tract 8366, Cook, IL",1958,328,1096,280,1096,280,1041,267,55,55,0,11,862,239
14000US17031836700,"Census Tract 8367, Cook, IL",1608,247,1051,180,1051,180,923,181,128,62,0,11,557,169
14000US17031836800,"Census Tract 8368, Cook, IL",1651,238,655,141,655,141,518,141,137,84,0,11,996,229
14000US17031836900,"Census Tract 8369, Cook, IL",983,176,497,133,497,133,385,98,112,70,0,11,486,143
14000US17031837000,"Census Tract 8370, Cook, IL",1345,165,701,115,701,115,585,101,116,58,0,11,644,132
14000US17031837100,"Census Tract 8371, Cook, IL",1460,187,765,166,765,166,602,144,163,70,0,11,695,125
14000US17031837300,"Census Tract 8373, Cook, IL",1750,225,807,128,807,128,718,125,89,48,0,11,943,201
14000US17031837400,"Census Tract 8374, Cook, IL",1962,278,1092,188,1092,188,841,165,251,91,0,11,870,192
14000US17031837800,"Census Tract 8378, Cook, IL",2384,292,1555,265,1555,265,1315,253,240,133,0,11,829,161
14000US17031838000,"Census Tract 8380, Cook, IL",2200,243,1417,278,1417,278,1192,236,225,182,0,11,783,145
14000US17031838100,"Census Tract 8381, Cook, IL",1835,207,1020,222,1020,222,799,193,221,166,0,11,815,135
14000US17031838200,"Census Tract 8382, Cook, IL",1901,328,875,178,875,178,817,154,58,40,0,11,1026,284
14000US17031838300,"Census Tract 8383, Cook, IL",1288,158,898,112,898,112,830,98,68,39,0,11,390,124
14000US17031838600,"Census Tract 8386, Cook, IL",1034,188,326,111,326,111,264,77,62,61,0,11,708,160
14000US17031838700,"Census Tract 8387, Cook, IL",3341,488,1699,360,1699,360,1261,270,438,194,0,11,1642,390
14000US17031838800,"Census Tract 8388, Cook, IL",2267,280,1205,234,1205,234,914,174,291,112,0,11,1062,193
14000US17031839000,"Census Tract 8390, Cook, IL",7954,667,6240,659,6158,647,5963,646,195,120,82,110,1714,439
14000US17031839100,"Census Tract 8391, Cook, IL",6329,468,4420,438,4420,438,4170,415,250,129,0,15,1909,277
14000US17031839200,"Census Tract 8392, Cook, IL",2110,234,1244,217,1244,217,1135,201,109,70,0,11,866,171
14000US17031839500,"Census Tract 8395, Cook, IL",1279,143,545,125,545,125,537,124,8,13,0,11,734,150
14000US17031839600,"Census Tract 8396, Cook, IL",1396,205,757,164,757,164,675,152,82,43,0,11,639,128
14000US17031839700,"Census Tract 8397, Cook, IL",3679,328,2587,248,2587,248,2403,233,184,73,0,11,1092,207
14000US17031839800,"Census Tract 8398, Cook, IL",2485,210,1507,215,1507,215,1450,211,57,43,0,11,978,207
14000US17031839900,"Census Tract 8399, Cook, IL",3634,239,2370,246,2370,246,2226,244,144,62,0,11,1264,215
14000US17031840000,"Census Tract 8400, Cook, IL",2291,245,1616,190,1616,190,1482,179,134,68,0,11,675,201
14000US17031840100,"Census Tract 8401, Cook, IL",2498,308,1647,299,1647,299,1494,246,153,99,0,11,851,164
14000US17031840200,"Census Tract 8402, Cook, IL",2046,198,1317,169,1317,169,1182,145,135,96,0,11,729,114
14000US17031840300,"Census Tract 8403, Cook, IL",3115,308,1981,285,1981,285,1727,276,254,112,0,11,1134,194
14000US17031840400,"Census Tract 8404, Cook, IL",2546,240,1530,179,1530,179,1352,168,178,99,0,11,1016,172
14000US17031840700,"Census Tract 8407, Cook, IL",2794,383,1695,292,1695,292,1510,262,185,101,0,11,1099,284
14000US17031840800,"Census Tract 8408, Cook, IL",2045,244,1215,169,1215,169,1139,171,76,51,0,11,830,183
14000US17031841000,"Census Tract 8410, Cook, IL",778,98,534,86,534,86,507,84,27,25,0,11,244,72
14000US17031841100,"Census Tract 8411, Cook, IL",6020,597,3510,414,3510,414,3184,419,326,152,0,15,2510,356
14000US17031841200,"Census Tract 8412, Cook, IL",3897,355,2809,307,2809,307,2587,286,222,124,0,15,1088,222
14000US17031841300,"Census Tract 8413, Cook, IL",3215,362,2234,283,2234,283,2105,267,129,66,0,11,981,210
14000US17031841400,"Census Tract 8414, Cook, IL",893,162,558,127,558,127,480,114,78,54,0,11,335,130
14000US17031841500,"Census Tract 8415, Cook, IL",2184,266,1149,216,1149,216,915,194,234,92,0,11,1035,181
14000US17031841600,"Census Tract 8416, Cook, IL",510,115,231,65,231,65,202,60,29,20,0,11,279,82
14000US17031841700,"Census Tract 8417, Cook, IL",1250,247,532,130,532,130,450,108,82,57,0,11,718,247
14000US17031841800,"Census Tract 8418, Cook, IL",1940,213,1107,163,1107,163,823,154,284,89,0,11,833,142
14000US17031841900,"Census Tract 8419, Cook, IL",5948,427,3882,387,3869,384,3490,287,379,213,13,20,2066,322
14000US17031842000,"Census Tract 8420, Cook, IL",3042,313,1041,136,1041,136,996,136,45,28,0,11,2001,287
14000US17031842100,"Census Tract 8421, Cook, IL",4814,806,3022,632,3022,632,2597,604,425,190,0,15,1792,466
14000US17031842200,"Census Tract 8422, Cook, IL",2921,256,2175,215,2175,215,2142,216,33,27,0,11,746,176
14000US17031842300,"Census Tract 8423, Cook, IL",2798,400,2389,394,2389,394,2264,351,125,82,0,11,409,122
14000US17031842400,"Census Tract 8424, Cook, IL",2559,301,1448,246,1448,246,1102,201,346,132,0,11,1111,182
14000US17031842500,"Census Tract 8425, Cook, IL",1170,192,518,113,518,113,318,96,200,76,0,11,652,144
14000US17031842600,"Census Tract 8426, Cook, IL",3359,273,2315,244,2315,244,2013,252,302,130,0,11,1044,198
14000US17031842800,"Census Tract 8428, Cook, IL",5109,573,3010,409,3010,409,2683,351,327,179,0,15,2099,358
14000US17031842900,"Census Tract 8429, Cook, IL",1658,227,902,190,902,190,833,200,69,58,0,11,756,197
14000US17031843000,"Census Tract 8430, Cook, IL",1750,192,905,158,905,158,759,153,146,74,0,11,845,182
14000US17031843100,"Census Tract 8431, Cook, IL",1203,282,613,145,613,145,566,148,47,32,0,11,590,212
14000US17031843200,"Census Tract 8432, Cook, IL",1775,199,1159,176,1159,176,1060,154,99,56,0,11,616,118
14000US17031843300,"Census Tract 8433, Cook, IL",1666,282,892,206,892,206,757,201,135,66,0,11,774,247
14000US17031843400,"Census Tract 8434, Cook, IL",964,190,618,137,618,137,553,116,65,47,0,11,346,113
14000US17031843500,"Census Tract 8435, Cook, IL",9803,668,530,116,530,116,490,114,40,36,0,17,9273,693
14000US17031843600,"Census Tract 8436, Cook, IL",2077,301,1238,202,1238,202,932,156,306,134,0,11,839,249
14000US17031843700,"Census Tract 8437, Cook, IL",1890,175,1455,132,1439,131,1378,125,61,37,16,17,435,91
14000US17031843800,"Census Tract 8438, Cook, IL",1298,180,803,145,803,145,654,137,149,67,0,11,495,125
14000US17031843900,"Census Tract 8439, Cook, IL",2927,339,1308,197,1308,197,1188,178,120,104,0,11,1619,319
14000US17031980000,"Census Tract 9800, Cook, IL",0,11,0,11,0,11,0,11,0,11,0,11,0,11
14000US17031980100,"Census Tract 9801, Cook, IL",0,11,0,11,0,11,0,11,0,11,0,11,0,11
14000US17043840000,"Census Tract 8400, DuPage, IL",2416,197,1779,184,1779,184,1616,163,163,69,0,11,637,130
14000US17043840801,"Census Tract 8408.01, DuPage, IL",1850,195,962,137,962,137,844,152,118,81,0,11,888,178
